publish_date,author_num,degree_avg,degree_med,title_word_num,body_word_num,word_num,image_num
1579582800.0,2,2.0,2,8,1794,1802,1
1579669200.0,1,1.0,1,9,868,877,1
1579755600.0,1,8.0,8,8,2485,2493,1
1579842000.0,0,0.0,0,7,1299,1306,1
1579842000.0,9,8.333333333333334,8,8,195,203,1
1580101200.0,0,0.0,0,8,497,505,1
1580187600.0,1,0.0,0,6,1595,1601,1
1580274000.0,0,0.0,0,7,1406,1413,1
1580360400.0,0,0.0,0,11,376,387,1
1580360400.0,1,0.0,0,3,941,944,1
1580446800.0,0,0.0,0,11,683,694,1
1580792400.0,0,0.0,0,4,467,471,1
1580792400.0,0,0.0,0,8,1120,1128,1
1580878800.0,0,0.0,0,7,747,754,1
1580965200.0,1,0.0,0,8,462,470,1
1581138000.0,1,0.0,0,10,204,214,1
1581138000.0,0,0.0,0,9,642,651,1
1581310800.0,0,0.0,0,10,869,879,1
1581310800.0,1,0.0,0,5,1473,1478,1
1581310800.0,1,0.0,0,7,523,530,1
1581483600.0,0,0.0,0,11,1229,1240,1
1581915600.0,0,0.0,0,5,524,529,1
1582088400.0,0,0.0,0,8,920,928,1
1582520400.0,0,0.0,0,6,1179,1185,1
1582606800.0,0,0.0,0,11,253,264,1
1582693200.0,1,0.0,0,8,660,668,1
1582779600.0,0,0.0,0,10,73,83,1
1582779600.0,0,0.0,0,7,720,727,1
1582866000.0,1,0.0,0,8,511,519,1
1582866000.0,1,0.0,0,9,986,995,1
1582866000.0,3,4.0,5,9,1017,1026,1
1582866000.0,0,0.0,0,6,692,698,1
1583125200.0,1,0.0,0,8,737,745,1
1583125200.0,1,0.0,0,9,374,383,1
1583125200.0,1,0.0,0,7,96,103,1
1583125200.0,0,0.0,0,5,236,241,1
1583211600.0,1,0.0,0,9,1156,1165,1
1583298000.0,2,1.0,1,11,305,316,1
1583298000.0,0,0.0,0,6,1019,1025,1
1583384400.0,0,0.0,0,10,1335,1345,1
1583384400.0,0,0.0,0,12,885,897,1
1583470800.0,1,0.0,0,7,164,171,1
1583557200.0,1,8.0,8,12,391,403,1
1583726400.0,1,1.0,1,9,263,272,1
1583726400.0,0,0.0,0,6,892,898,1
1583726400.0,1,0.0,0,14,347,361,1
1583726400.0,1,0.0,0,15,407,422,1
1583726400.0,1,0.0,0,6,96,102,1
1583812800.0,4,3.25,3,6,483,489,1
1583812800.0,0,0.0,0,12,440,452,1
1583812800.0,0,0.0,0,10,273,283,1
1583812800.0,1,0.0,0,12,637,649,1
1583899200.0,0,0.0,0,3,602,605,1
1583899200.0,1,0.0,0,12,274,286,1
1583899200.0,1,0.0,0,14,2902,2916,1
1583985600.0,2,1.0,1,10,4630,4640,1
1583985600.0,0,0.0,0,8,415,423,1
1583985600.0,0,0.0,0,7,915,922,1
1583985600.0,0,0.0,0,9,842,851,1
1583985600.0,1,0.0,0,7,270,277,1
1583985600.0,2,1.5,1,9,395,404,1
1583985600.0,1,2.0,2,6,152,158,1
1583985600.0,1,0.0,0,12,684,696,1
1583985600.0,1,0.0,0,7,400,407,1
1583985600.0,2,1.0,1,8,79,87,1
1583985600.0,1,0.0,0,18,680,698,1
1583985600.0,0,0.0,0,9,146,155,1
1583985600.0,0,0.0,0,4,1134,1138,1
1584072000.0,2,3.5,3,11,597,608,1
1584072000.0,1,0.0,0,12,188,200,1
1584072000.0,1,0.0,0,16,1698,1714,1
1584072000.0,1,0.0,0,12,1126,1138,1
1584072000.0,2,1.5,1,6,602,608,1
1584072000.0,1,0.0,0,7,148,155,1
1584158400.0,1,0.0,0,12,658,670,1
1584158400.0,1,0.0,0,7,1014,1021,1
1584244800.0,1,2.0,2,19,223,242,1
1584331200.0,0,0.0,0,13,273,286,1
1584331200.0,1,1.0,1,6,1478,1484,1
1584331200.0,0,0.0,0,11,1782,1793,1
1584331200.0,1,0.0,0,15,332,347,1
1584331200.0,2,2.0,2,12,640,652,1
1584331200.0,1,0.0,0,13,911,924,1
1584331200.0,0,0.0,0,9,3344,3353,1
1584331200.0,0,0.0,0,9,440,449,1
1584331200.0,1,0.0,0,8,96,104,1
1584331200.0,1,0.0,0,11,441,452,1
1584417600.0,2,1.0,1,13,1094,1107,1
1584417600.0,1,0.0,0,12,1741,1753,1
1584417600.0,0,0.0,0,9,259,268,1
1584417600.0,1,0.0,0,7,1920,1927,1
1584417600.0,1,0.0,0,13,335,348,1
1584417600.0,0,0.0,0,5,155,160,1
1584417600.0,1,0.0,0,13,610,623,1
1584417600.0,1,2.0,2,23,382,405,1
1584417600.0,0,0.0,0,10,210,220,1
1584504000.0,0,0.0,0,8,417,425,1
1584504000.0,1,0.0,0,11,676,687,1
1584504000.0,2,1.0,1,9,1126,1135,1
1584504000.0,2,1.0,1,10,2833,2843,1
1584590400.0,2,1.5,1,13,1319,1332,1
1584590400.0,0,0.0,0,3,889,892,1
1584590400.0,0,0.0,0,12,216,228,1
1584590400.0,1,0.0,0,11,914,925,1
1584590400.0,1,0.0,0,10,270,280,1
1584590400.0,2,2.0,2,20,1089,1109,1
1584590400.0,1,2.0,2,12,419,431,1
1584590400.0,1,0.0,0,11,240,251,1
1584590400.0,1,8.0,8,12,617,629,1
1584590400.0,0,0.0,0,10,316,326,1
1584590400.0,0,0.0,0,9,206,215,1
1584590400.0,1,0.0,0,9,1193,1202,1
1584590400.0,1,8.0,8,11,716,727,1
1584676800.0,1,0.0,0,12,861,873,1
1584676800.0,1,0.0,0,13,455,468,1
1584676800.0,1,0.0,0,11,327,338,1
1584676800.0,0,0.0,0,11,694,705,1
1584676800.0,1,0.0,0,12,899,911,1
1584676800.0,1,0.0,0,12,810,822,1
1584676800.0,1,0.0,0,7,180,187,1
1584763200.0,1,8.0,8,13,230,243,1
1584763200.0,1,0.0,0,9,1017,1026,1
1584763200.0,2,1.0,1,8,2882,2890,1
1584763200.0,1,1.0,1,10,524,534,1
1584763200.0,1,1.0,1,8,489,497,1
1584763200.0,1,0.0,0,10,818,828,1
1584849600.0,1,0.0,0,14,1414,1428,1
1584936000.0,0,0.0,0,6,396,402,1
1584936000.0,0,0.0,0,8,391,399,1
1584936000.0,0,0.0,0,6,1241,1247,1
1584936000.0,1,0.0,0,13,96,109,1
1584936000.0,0,0.0,0,16,355,371,1
1584936000.0,1,2.0,2,16,954,970,1
1584936000.0,1,2.0,2,9,615,624,1
1584936000.0,1,8.0,8,7,562,569,1
1584936000.0,1,0.0,0,13,1004,1017,1
1584936000.0,1,0.0,0,9,251,260,1
1584936000.0,1,1.0,1,13,397,410,1
1585022400.0,0,0.0,0,7,311,318,1
1585022400.0,1,0.0,0,2,1161,1163,1
1585022400.0,1,0.0,0,10,377,387,1
1585022400.0,1,0.0,0,8,1534,1542,1
1585022400.0,1,0.0,0,9,396,405,1
1585022400.0,1,0.0,0,7,680,687,1
1585022400.0,0,0.0,0,11,1514,1525,1
1585022400.0,1,8.0,8,12,598,610,1
1585022400.0,1,2.0,2,4,1148,1152,1
1585022400.0,1,0.0,0,11,1725,1736,1
1585022400.0,1,9.0,9,15,343,358,1
1585108800.0,1,0.0,0,10,288,298,1
1585108800.0,1,0.0,0,11,294,305,1
1585108800.0,0,0.0,0,10,1344,1354,1
1585108800.0,1,0.0,0,7,1392,1399,1
1585108800.0,1,0.0,0,16,491,507,1
1585108800.0,1,0.0,0,8,577,585,1
1585108800.0,0,0.0,0,6,582,588,1
1585108800.0,1,0.0,0,5,509,514,1
1585195200.0,2,1.0,1,15,1352,1367,1
1585195200.0,1,0.0,0,16,226,242,1
1585195200.0,0,0.0,0,13,531,544,1
1585195200.0,1,0.0,0,9,675,684,1
1585195200.0,1,0.0,0,16,145,161,1
1585195200.0,1,0.0,0,10,894,904,1
1585195200.0,1,8.0,8,12,864,876,1
1585195200.0,1,0.0,0,14,735,749,1
1585195200.0,1,0.0,0,13,623,636,1
1585195200.0,0,0.0,0,8,1273,1281,1
1585195200.0,0,0.0,0,11,1337,1348,1
1585195200.0,1,0.0,0,9,374,383,1
1585281600.0,1,0.0,0,9,1102,1111,1
1585281600.0,1,2.0,2,11,705,716,1
1585281600.0,1,0.0,0,12,294,306,1
1585281600.0,1,0.0,0,11,1375,1386,1
1585281600.0,0,0.0,0,6,61,67,1
1585281600.0,1,8.0,8,12,495,507,1
1585281600.0,1,0.0,0,12,1109,1121,1
1585281600.0,1,0.0,0,8,905,913,1
1585281600.0,1,2.0,2,12,786,798,1
1585281600.0,1,0.0,0,9,1064,1073,1
1585281600.0,1,0.0,0,14,562,576,1
1585281600.0,1,2.0,2,8,590,598,1
1585281600.0,1,0.0,0,6,1428,1434,1
1585281600.0,0,0.0,0,14,312,326,1
1585368000.0,1,0.0,0,13,534,547,1
1585368000.0,1,1.0,1,9,503,512,1
1585454400.0,0,0.0,0,9,261,270,1
1585540800.0,1,0.0,0,10,530,540,1
1585540800.0,1,0.0,0,14,96,110,1
1585540800.0,3,2.3333333333333335,2,9,227,236,1
1585540800.0,0,0.0,0,8,555,563,1
1585540800.0,0,0.0,0,11,962,973,1
1585540800.0,2,1.0,1,12,1350,1362,1
1585540800.0,0,0.0,0,6,1927,1933,1
1585540800.0,0,0.0,0,4,93,97,1
1585540800.0,0,0.0,0,8,214,222,1
1585627200.0,0,0.0,0,11,1593,1604,1
1585627200.0,1,0.0,0,12,1776,1788,1
1585627200.0,1,2.0,2,12,456,468,1
1585627200.0,1,0.0,0,15,374,389,1
1585627200.0,1,0.0,0,13,618,631,1
1585627200.0,1,0.0,0,12,1162,1174,1
1585627200.0,1,8.0,8,14,794,808,1
1585713600.0,0,0.0,0,4,506,510,1
1585713600.0,1,8.0,8,10,594,604,1
1585713600.0,0,0.0,0,15,369,384,1
1585713600.0,0,0.0,0,4,440,444,1
1585713600.0,1,8.0,8,12,295,307,1
1585713600.0,2,1.0,1,13,1340,1353,1
1585713600.0,0,0.0,0,6,134,140,1
1585713600.0,0,0.0,0,8,102,110,1
1585713600.0,1,0.0,0,11,577,588,1
1585713600.0,1,0.0,0,15,817,832,1
1585713600.0,0,0.0,0,10,189,199,1
1585800000.0,1,0.0,0,12,326,338,1
1585800000.0,1,0.0,0,9,1079,1088,1
1585800000.0,0,0.0,0,12,139,151,1
1585800000.0,1,0.0,0,15,1982,1997,1
1585800000.0,1,0.0,0,12,326,338,1
1585800000.0,1,2.0,2,14,1046,1060,1
1585800000.0,1,8.0,8,10,538,548,1
1585800000.0,1,3.0,3,7,605,612,1
1585800000.0,1,1.0,1,9,197,206,1
1585800000.0,1,1.0,1,14,344,358,1
1585800000.0,1,1.0,1,8,315,323,1
1585800000.0,1,0.0,0,14,605,619,1
1585800000.0,0,0.0,0,9,141,150,1
1585800000.0,0,0.0,0,7,564,571,1
1585886400.0,0,0.0,0,7,1041,1048,1
1585886400.0,0,0.0,0,6,390,396,1
1585886400.0,1,0.0,0,12,441,453,1
1585886400.0,1,1.0,1,13,296,309,1
1585886400.0,0,0.0,0,12,1480,1492,1
1585886400.0,1,0.0,0,10,744,754,1
1585886400.0,1,0.0,0,12,647,659,1
1585886400.0,0,0.0,0,5,330,335,1
1585886400.0,1,0.0,0,9,605,614,1
1585886400.0,1,0.0,0,12,1447,1459,1
1585972800.0,1,0.0,0,16,1375,1391,1
1585972800.0,1,0.0,0,6,4014,4020,0
1585972800.0,1,0.0,0,12,582,594,1
1586059200.0,2,1.0,1,8,1448,1456,1
1586145600.0,0,0.0,0,3,996,999,1
1586145600.0,1,0.0,0,14,901,915,1
1586145600.0,1,0.0,0,9,96,105,1
1586145600.0,1,0.0,0,3,808,811,1
1586145600.0,0,0.0,0,9,355,364,1
1586145600.0,1,0.0,0,11,466,477,1
1586145600.0,1,0.0,0,16,363,379,1
1586145600.0,1,0.0,0,12,396,408,1
1586145600.0,2,1.0,1,12,673,685,1
1586145600.0,1,0.0,0,8,974,982,1
1586145600.0,0,0.0,0,12,4024,4036,1
1586145600.0,1,1.0,1,8,445,453,1
1586145600.0,1,0.0,0,16,675,691,1
1586232000.0,1,0.0,0,12,273,285,1
1586232000.0,1,0.0,0,8,119,127,1
1586232000.0,1,3.0,3,12,264,276,1
1586232000.0,0,0.0,0,11,454,465,1
1586232000.0,1,0.0,0,12,223,235,1
1586232000.0,0,0.0,0,13,536,549,1
1586232000.0,0,0.0,0,10,857,867,1
1586232000.0,1,0.0,0,7,691,698,1
1586232000.0,1,8.0,8,12,734,746,1
1586318400.0,1,0.0,0,12,740,752,1
1586318400.0,1,1.0,1,11,1525,1536,1
1586318400.0,1,0.0,0,9,223,232,1
1586318400.0,0,0.0,0,9,2133,2142,1
1586318400.0,1,0.0,0,10,1035,1045,1
1586404800.0,0,0.0,0,9,1032,1041,1
1586404800.0,0,0.0,0,7,819,826,1
1586404800.0,1,0.0,0,11,512,523,1
1586404800.0,1,0.0,0,14,735,749,1
1586404800.0,1,0.0,0,5,229,234,1
1586404800.0,0,0.0,0,10,4418,4428,1
1586404800.0,1,1.0,1,12,428,440,1
1586404800.0,1,2.0,2,10,1602,1612,1
1586404800.0,0,0.0,0,7,4921,4928,1
1586404800.0,1,5.0,5,9,1282,1291,1
1586404800.0,1,0.0,0,11,7163,7174,1
1586404800.0,1,2.0,2,14,2033,2047,1
1586404800.0,1,0.0,0,11,364,375,1
1586491200.0,0,0.0,0,10,422,432,1
1586491200.0,1,0.0,0,14,545,559,1
1586491200.0,0,0.0,0,6,244,250,1
1586491200.0,1,8.0,8,9,3669,3678,1
1586491200.0,1,2.0,2,12,1269,1281,1
1586491200.0,1,0.0,0,13,241,254,1
1586491200.0,1,0.0,0,9,746,755,1
1586491200.0,1,0.0,0,12,246,258,1
1586491200.0,1,0.0,0,7,963,970,1
1586491200.0,1,2.0,2,10,289,299,1
1586491200.0,1,2.0,2,10,401,411,1
1586491200.0,1,0.0,0,10,1063,1073,1
1586491200.0,0,0.0,0,16,847,863,1
1586577600.0,1,1.0,1,6,509,515,1
1586577600.0,0,0.0,0,15,1665,1680,1
1586577600.0,0,0.0,0,10,264,274,1
1586577600.0,1,1.0,1,6,538,544,1
1586577600.0,0,0.0,0,11,3820,3831,1
1586664000.0,4,3.0,3,14,2531,2545,1
1586750400.0,0,0.0,0,5,539,544,1
1586750400.0,1,0.0,0,10,591,601,1
1586750400.0,1,0.0,0,11,554,565,1
1586750400.0,0,0.0,0,9,70,79,1
1586750400.0,0,0.0,0,14,668,682,1
1586750400.0,0,0.0,0,9,693,702,1
1586750400.0,1,0.0,0,13,96,109,1
1586750400.0,1,0.0,0,11,560,571,1
1586750400.0,1,0.0,0,9,1593,1602,1
1586750400.0,2,2.0,2,17,521,538,1
1586750400.0,1,0.0,0,10,840,850,1
1586750400.0,0,0.0,0,10,1691,1701,1
1586750400.0,2,1.0,1,13,1298,1311,1
1586750400.0,1,0.0,0,8,407,415,1
1586750400.0,0,0.0,0,8,474,482,1
1586750400.0,0,0.0,0,11,185,196,1
1586750400.0,2,2.5,2,10,776,786,1
1586836800.0,0,0.0,0,9,1336,1345,1
1586836800.0,1,2.0,2,13,588,601,1
1586836800.0,1,2.0,2,9,486,495,1
1586836800.0,1,0.0,0,11,237,248,1
1586836800.0,1,3.0,3,16,798,814,1
1586836800.0,1,1.0,1,11,835,846,1
1586836800.0,1,0.0,0,16,416,432,1
1586836800.0,0,0.0,0,8,254,262,1
1586923200.0,1,0.0,0,8,336,344,1
1586923200.0,1,0.0,0,8,762,770,1
1586923200.0,1,0.0,0,7,308,315,1
1586923200.0,0,0.0,0,12,2200,2212,1
1586923200.0,1,0.0,0,10,293,303,1
1586923200.0,0,0.0,0,8,454,462,1
1586923200.0,2,1.0,1,9,1184,1193,1
1586923200.0,2,3.0,3,9,292,301,1
1586923200.0,0,0.0,0,7,507,514,1
1587009600.0,1,0.0,0,14,619,633,1
1587009600.0,0,0.0,0,7,134,141,1
1587009600.0,1,1.0,1,12,225,237,1
1587009600.0,0,0.0,0,9,921,930,1
1587009600.0,1,0.0,0,8,265,273,1
1587009600.0,1,0.0,0,5,988,993,1
1587009600.0,0,0.0,0,15,515,530,1
1587009600.0,1,0.0,0,14,471,485,1
1587009600.0,1,8.0,8,11,758,769,1
1587009600.0,1,0.0,0,8,734,742,1
1587009600.0,0,0.0,0,17,4774,4791,1
1587009600.0,1,0.0,0,12,1048,1060,1
1587009600.0,0,0.0,0,8,569,577,1
1587009600.0,1,0.0,0,15,387,402,1
1587096000.0,1,0.0,0,6,639,645,1
1587096000.0,1,0.0,0,9,717,726,1
1587096000.0,1,1.0,1,10,654,664,1
1587096000.0,1,8.0,8,10,393,403,1
1587096000.0,1,0.0,0,8,1192,1200,1
1587096000.0,1,0.0,0,12,790,802,1
1587096000.0,0,0.0,0,22,2102,2124,1
1587096000.0,0,0.0,0,8,493,501,1
1587096000.0,0,0.0,0,13,6202,6215,1
1587096000.0,0,0.0,0,7,2293,2300,1
1587096000.0,1,0.0,0,9,1784,1793,1
1587096000.0,0,0.0,0,10,5594,5604,0
1587096000.0,1,0.0,0,10,1816,1826,1
1587096000.0,1,0.0,0,11,216,227,1
1587096000.0,1,0.0,0,9,361,370,1
1587096000.0,1,0.0,0,12,819,831,1
1587182400.0,1,0.0,0,12,1177,1189,1
1587182400.0,1,8.0,8,11,191,202,1
1587182400.0,1,0.0,0,19,1235,1254,1
1587182400.0,1,0.0,0,10,617,627,1
1587182400.0,1,1.0,1,10,516,526,1
1587182400.0,1,0.0,0,10,6336,6346,1
1587268800.0,1,0.0,0,11,449,460,1
1587355200.0,1,0.0,0,14,308,322,1
1587355200.0,1,0.0,0,11,330,341,1
1587355200.0,0,0.0,0,11,325,336,1
1587355200.0,1,0.0,0,10,1312,1322,1
1587355200.0,0,0.0,0,12,434,446,1
1587355200.0,1,3.0,3,13,800,813,1
1587355200.0,0,0.0,0,11,6034,6045,1
1587355200.0,1,3.0,3,10,688,698,1
1587355200.0,0,0.0,0,17,995,1012,1
1587355200.0,0,0.0,0,9,911,920,1
1587355200.0,1,0.0,0,11,1393,1404,1
1587355200.0,1,0.0,0,10,96,106,1
1587355200.0,1,1.0,1,8,1022,1030,1
1587355200.0,1,8.0,8,9,1039,1048,1
1587355200.0,0,0.0,0,26,770,796,1
1587355200.0,1,8.0,8,14,425,439,1
1587441600.0,1,8.0,8,13,1052,1065,1
1587441600.0,1,0.0,0,11,673,684,1
1587441600.0,1,0.0,0,10,4499,4509,1
1587441600.0,1,8.0,8,9,350,359,1
1587441600.0,1,1.0,1,13,466,479,1
1587441600.0,1,0.0,0,12,448,460,1
1587441600.0,0,0.0,0,9,970,979,1
1587441600.0,1,2.0,2,22,863,885,1
1587441600.0,0,0.0,0,11,451,462,1
1587441600.0,1,0.0,0,13,843,856,1
1587441600.0,1,0.0,0,6,1550,1556,1
1587441600.0,1,0.0,0,9,374,383,1
1587528000.0,1,0.0,0,12,338,350,1
1587528000.0,1,0.0,0,9,675,684,1
1587528000.0,0,0.0,0,9,3721,3730,1
1587528000.0,0,0.0,0,6,1166,1172,1
1587528000.0,1,1.0,1,10,203,213,1
1587528000.0,1,0.0,0,12,1124,1136,1
1587528000.0,1,0.0,0,11,639,650,1
1587528000.0,0,0.0,0,12,733,745,1
1587528000.0,1,0.0,0,11,645,656,1
1587614400.0,1,0.0,0,11,711,722,1
1587614400.0,0,0.0,0,15,1384,1399,1
1587614400.0,1,1.0,1,13,415,428,1
1587614400.0,1,1.0,1,14,199,213,1
1587614400.0,1,3.0,3,6,849,855,1
1587614400.0,0,0.0,0,14,374,388,1
1587614400.0,0,0.0,0,8,637,645,1
1587614400.0,4,4.0,4,11,796,807,1
1587614400.0,0,0.0,0,17,597,614,1
1587614400.0,0,0.0,0,13,898,911,1
1587614400.0,0,0.0,0,14,851,865,1
1587614400.0,0,0.0,0,9,2356,2365,1
1587700800.0,1,9.0,9,11,415,426,1
1587700800.0,1,0.0,0,16,819,835,1
1587700800.0,1,0.0,0,11,369,380,1
1587700800.0,0,0.0,0,8,3675,3683,1
1587700800.0,0,0.0,0,15,298,313,1
1587700800.0,1,0.0,0,11,269,280,1
1587700800.0,1,9.0,9,13,486,499,1
1587700800.0,0,0.0,0,6,358,364,1
1587700800.0,0,0.0,0,22,1551,1573,1
1587700800.0,1,0.0,0,14,41,55,1
1587700800.0,1,8.0,8,16,695,711,1
1587700800.0,1,0.0,0,8,1848,1856,1
1587700800.0,0,0.0,0,11,820,831,1
1587700800.0,2,2.0,2,11,473,484,1
1587700800.0,1,0.0,0,14,382,396,1
1587700800.0,0,0.0,0,6,993,999,1
1587787200.0,0,0.0,0,17,757,774,1
1587787200.0,1,8.0,8,13,250,263,1
1587787200.0,1,0.0,0,11,650,661,1
1587787200.0,1,1.0,1,11,525,536,1
1587787200.0,1,8.0,8,12,183,195,1
1587787200.0,1,0.0,0,11,874,885,1
1587873600.0,1,0.0,0,10,485,495,1
1587873600.0,1,0.0,0,14,2102,2116,1
1587873600.0,0,0.0,0,11,429,440,1
1587873600.0,1,8.0,8,13,336,349,1
1587873600.0,1,0.0,0,15,3307,3322,1
1587960000.0,0,0.0,0,7,305,312,1
1587960000.0,0,0.0,0,13,2029,2042,1
1587960000.0,0,0.0,0,11,186,197,1
1587960000.0,2,1.0,1,14,1711,1725,1
1587960000.0,1,3.0,3,12,370,382,1
1587960000.0,1,0.0,0,12,807,819,1
1587960000.0,1,0.0,0,12,1546,1558,1
1587960000.0,0,0.0,0,11,217,228,1
1587960000.0,1,0.0,0,11,96,107,1
1587960000.0,1,1.0,1,9,573,582,1
1587960000.0,1,0.0,0,11,404,415,1
1587960000.0,1,0.0,0,10,2140,2150,1
1587960000.0,1,3.0,3,8,659,667,1
1587960000.0,1,0.0,0,14,800,814,1
1587960000.0,2,2.0,2,17,704,721,1
1587960000.0,1,0.0,0,11,1349,1360,1
1587960000.0,2,2.5,2,9,1453,1462,1
1588046400.0,0,0.0,0,9,145,154,1
1588046400.0,1,1.0,1,12,357,369,1
1588046400.0,1,0.0,0,9,940,949,1
1588046400.0,1,0.0,0,13,665,678,1
1588046400.0,1,2.0,2,11,304,315,1
1588046400.0,0,0.0,0,10,931,941,1
1588046400.0,1,1.0,1,8,293,301,1
1588046400.0,1,8.0,8,7,460,467,1
1588046400.0,0,0.0,0,9,468,477,1
1588046400.0,1,3.0,3,20,665,685,1
1588046400.0,1,2.0,2,16,515,531,1
1588046400.0,2,1.0,1,9,1588,1597,1
1588046400.0,1,0.0,0,13,270,283,1
1588046400.0,1,8.0,8,11,376,387,1
1588046400.0,1,8.0,8,13,635,648,1
1588046400.0,0,0.0,0,9,546,555,1
1588046400.0,0,0.0,0,12,385,397,1
1588046400.0,0,0.0,0,15,590,605,1
1588046400.0,0,0.0,0,10,2851,2861,1
1588046400.0,0,0.0,0,9,1323,1332,1
1588132800.0,0,0.0,0,10,197,207,1
1588132800.0,0,0.0,0,15,816,831,1
1588132800.0,1,0.0,0,9,1555,1564,1
1588132800.0,1,0.0,0,14,1994,2008,1
1588132800.0,1,9.0,9,9,523,532,1
1588132800.0,1,2.0,2,13,491,504,1
1588132800.0,1,0.0,0,11,3016,3027,1
1588132800.0,1,0.0,0,11,1010,1021,1
1588132800.0,1,8.0,8,10,220,230,1
1588132800.0,1,9.0,9,12,767,779,1
1588132800.0,1,0.0,0,16,1473,1489,1
1588132800.0,1,2.0,2,13,809,822,1
1588132800.0,1,0.0,0,16,371,387,1
1588132800.0,3,2.0,2,12,2821,2833,1
1588132800.0,0,0.0,0,12,125,137,1
1588132800.0,2,1.0,1,15,397,412,1
1588132800.0,1,8.0,8,14,662,676,1
1588132800.0,1,0.0,0,13,2001,2014,1
1588132800.0,2,1.5,1,17,922,939,1
1588132800.0,1,0.0,0,7,1071,1078,1
1588132800.0,0,0.0,0,14,358,372,1
1588132800.0,1,0.0,0,7,366,373,1
1588132800.0,1,0.0,0,15,408,423,1
1588219200.0,1,1.0,1,12,333,345,1
1588219200.0,2,1.0,1,11,396,407,1
1588219200.0,0,0.0,0,13,599,612,1
1588219200.0,1,0.0,0,12,545,557,1
1588219200.0,1,1.0,1,12,1361,1373,1
1588219200.0,1,1.0,1,11,340,351,1
1588219200.0,1,1.0,1,11,799,810,1
1588219200.0,0,0.0,0,18,2060,2078,1
1588219200.0,1,2.0,2,17,548,565,1
1588219200.0,1,0.0,0,8,312,320,1
1588219200.0,2,5.0,5,8,413,421,1
1588219200.0,1,8.0,8,7,863,870,1
1588219200.0,1,0.0,0,9,2019,2028,1
1588219200.0,0,0.0,0,9,826,835,1
1588219200.0,1,3.0,3,13,645,658,1
1588219200.0,0,0.0,0,11,220,231,1
1588219200.0,0,0.0,0,14,783,797,1
1588219200.0,1,0.0,0,8,1201,1209,1
1588219200.0,1,2.0,2,8,454,462,1
1588219200.0,0,0.0,0,9,611,620,1
1588219200.0,0,0.0,0,7,669,676,1
1588219200.0,1,0.0,0,14,749,763,1
1588219200.0,0,0.0,0,13,1046,1059,1
1588219200.0,2,1.0,1,8,1111,1119,1
1588219200.0,0,0.0,0,10,792,802,1
1588219200.0,0,0.0,0,18,477,495,1
1588219200.0,0,0.0,0,13,1314,1327,1
1588219200.0,1,0.0,0,13,265,278,1
1588219200.0,1,0.0,0,8,991,999,1
1588219200.0,2,1.0,1,7,1875,1882,1
1588219200.0,0,0.0,0,8,270,278,1
1588305600.0,1,0.0,0,10,237,247,1
1588305600.0,1,0.0,0,5,1808,1813,1
1588305600.0,1,1.0,1,11,677,688,1
1588305600.0,1,8.0,8,11,638,649,1
1588305600.0,0,0.0,0,8,549,557,1
1588305600.0,0,0.0,0,10,810,820,1
1588305600.0,1,0.0,0,15,1091,1106,1
1588305600.0,1,0.0,0,13,526,539,1
1588305600.0,0,0.0,0,9,197,206,1
1588305600.0,1,0.0,0,13,573,586,1
1588305600.0,0,0.0,0,12,2804,2816,1
1588305600.0,1,0.0,0,9,1088,1097,1
1588305600.0,1,1.0,1,8,569,577,1
1588305600.0,1,0.0,0,8,1318,1326,1
1588305600.0,1,0.0,0,15,363,378,1
1588305600.0,0,0.0,0,6,290,296,1
1588305600.0,1,0.0,0,17,292,309,1
1588305600.0,1,8.0,8,13,1052,1065,1
1588305600.0,3,2.0,2,10,2053,2063,1
1588305600.0,2,2.5,2,13,785,798,1
1588305600.0,2,1.0,1,10,1132,1142,1
1588305600.0,1,0.0,0,12,968,980,1
1588305600.0,1,0.0,0,9,1156,1165,1
1588305600.0,1,0.0,0,10,712,722,1
1588305600.0,1,0.0,0,13,591,604,1
1588305600.0,2,1.0,1,13,1426,1439,1
1588392000.0,1,0.0,0,19,693,712,1
1588392000.0,1,0.0,0,4,556,560,1
1588392000.0,2,4.5,4,14,965,979,1
1588392000.0,1,0.0,0,11,948,959,1
1588392000.0,1,1.0,1,9,548,557,1
1588392000.0,1,0.0,0,13,1072,1085,1
1588478400.0,0,0.0,0,13,1849,1862,1
1588478400.0,1,0.0,0,13,1613,1626,1
1588478400.0,1,0.0,0,14,811,825,1
1588478400.0,0,0.0,0,11,355,366,1
1588478400.0,1,0.0,0,14,2602,2616,1
1588478400.0,1,0.0,0,14,2031,2045,1
1588478400.0,1,0.0,0,9,1914,1923,1
1588478400.0,0,0.0,0,14,1979,1993,1
1588564800.0,0,0.0,0,9,537,546,1
1588564800.0,0,0.0,0,10,808,818,1
1588564800.0,1,1.0,1,8,196,204,1
1588564800.0,1,1.0,1,11,770,781,1
1588564800.0,0,0.0,0,13,823,836,1
1588564800.0,1,1.0,1,10,238,248,1
1588564800.0,2,1.0,1,10,1971,1981,1
1588564800.0,1,0.0,0,12,709,721,1
1588564800.0,1,1.0,1,9,272,281,1
1588564800.0,1,0.0,0,14,414,428,1
1588564800.0,1,0.0,0,8,1411,1419,1
1588564800.0,0,0.0,0,10,661,671,1
1588564800.0,1,0.0,0,10,355,365,1
1588564800.0,0,0.0,0,11,332,343,1
1588564800.0,0,0.0,0,10,512,522,1
1588564800.0,0,0.0,0,6,1236,1242,1
1588564800.0,0,0.0,0,10,1284,1294,1
1588564800.0,1,0.0,0,12,164,176,1
1588564800.0,1,0.0,0,13,96,109,1
1588564800.0,1,0.0,0,14,449,463,1
1588651200.0,1,0.0,0,16,440,456,1
1588651200.0,0,0.0,0,10,264,274,1
1588651200.0,2,1.0,1,15,1696,1711,1
1588651200.0,1,0.0,0,8,887,895,1
1588651200.0,2,1.0,1,11,1847,1858,1
1588651200.0,1,0.0,0,13,719,732,1
1588651200.0,1,2.0,2,10,699,709,1
1588651200.0,1,0.0,0,15,294,309,1
1588651200.0,2,1.5,1,13,1918,1931,1
1588651200.0,0,0.0,0,6,870,876,1
1588651200.0,1,0.0,0,1,2178,2179,0
1588651200.0,0,0.0,0,17,1229,1246,1
1588651200.0,0,0.0,0,9,1229,1238,1
1588651200.0,1,0.0,0,8,698,706,1
1588651200.0,0,0.0,0,9,231,240,1
1588651200.0,1,0.0,0,11,251,262,1
1588651200.0,0,0.0,0,8,384,392,1
1588651200.0,1,0.0,0,16,363,379,1
1588651200.0,1,0.0,0,9,183,192,1
1588651200.0,1,8.0,8,11,617,628,1
1588651200.0,0,0.0,0,7,947,954,1
1588651200.0,0,0.0,0,14,248,262,1
1588651200.0,0,0.0,0,8,1352,1360,1
1588651200.0,1,0.0,0,9,1326,1335,1
1588651200.0,1,1.0,1,9,192,201,1
1588737600.0,1,0.0,0,10,1495,1505,1
1588737600.0,1,0.0,0,6,1371,1377,1
1588737600.0,1,0.0,0,12,614,626,1
1588737600.0,3,2.0,2,9,1618,1627,1
1588737600.0,1,0.0,0,5,638,643,1
1588737600.0,0,0.0,0,8,88,96,1
1588737600.0,2,1.0,1,15,149,164,1
1588737600.0,1,0.0,0,7,1716,1723,1
1588737600.0,0,0.0,0,13,1237,1250,1
1588737600.0,1,0.0,0,15,228,243,1
1588737600.0,0,0.0,0,9,401,410,1
1588737600.0,1,0.0,0,18,1309,1327,1
1588737600.0,0,0.0,0,14,885,899,1
1588737600.0,1,1.0,1,9,666,675,1
1588737600.0,2,1.5,1,16,1093,1109,1
1588737600.0,1,0.0,0,24,345,369,1
1588737600.0,0,0.0,0,8,784,792,1
1588737600.0,2,1.0,1,5,1431,1436,1
1588737600.0,0,0.0,0,16,578,594,1
1588737600.0,1,0.0,0,10,574,584,1
1588737600.0,1,0.0,0,9,239,248,1
1588737600.0,1,0.0,0,12,490,502,1
1588737600.0,1,0.0,0,10,1730,1740,1
1588737600.0,1,0.0,0,9,1050,1059,1
1588737600.0,1,0.0,0,9,686,695,1
1588737600.0,1,0.0,0,6,176,182,1
1588824000.0,0,0.0,0,13,512,525,1
1588824000.0,1,0.0,0,10,399,409,1
1588824000.0,1,0.0,0,14,407,421,1
1588824000.0,1,0.0,0,10,3463,3473,1
1588824000.0,1,0.0,0,10,706,716,1
1588824000.0,2,4.5,4,21,689,710,1
1588824000.0,1,0.0,0,9,508,517,1
1588824000.0,1,1.0,1,11,724,735,1
1588824000.0,0,0.0,0,6,103,109,1
1588824000.0,1,8.0,8,10,566,576,1
1588824000.0,1,8.0,8,6,220,226,1
1588824000.0,1,0.0,0,13,228,241,1
1588824000.0,3,4.666666666666667,2,6,4025,4031,1
1588824000.0,1,0.0,0,13,707,720,1
1588824000.0,0,0.0,0,20,488,508,1
1588824000.0,0,0.0,0,13,918,931,1
1588824000.0,1,2.0,2,19,509,528,1
1588824000.0,1,0.0,0,9,1308,1317,1
1588824000.0,1,0.0,0,10,1229,1239,1
1588824000.0,0,0.0,0,13,316,329,1
1588824000.0,2,3.0,3,14,41,55,1
1588824000.0,1,3.0,3,16,770,786,1
1588824000.0,1,3.0,3,16,658,674,1
1588824000.0,1,0.0,0,9,1374,1383,1
1588824000.0,1,0.0,0,7,602,609,1
1588824000.0,2,1.5,1,8,406,414,1
1588824000.0,0,0.0,0,9,246,255,1
1588824000.0,1,0.0,0,10,692,702,1
1588824000.0,1,0.0,0,15,625,640,1
1588824000.0,0,0.0,0,9,591,600,0
1588824000.0,1,0.0,0,11,461,472,1
1588824000.0,0,0.0,0,13,356,369,1
1588824000.0,0,0.0,0,12,219,231,0
1588824000.0,1,0.0,0,17,233,250,1
1588824000.0,1,2.0,2,14,230,244,1
1588824000.0,1,1.0,1,10,154,164,1
1588910400.0,1,0.0,0,18,708,726,1
1588910400.0,0,0.0,0,10,322,332,1
1588910400.0,1,0.0,0,13,997,1010,1
1588910400.0,1,0.0,0,16,388,404,1
1588910400.0,0,0.0,0,4,692,696,1
1588910400.0,1,9.0,9,11,681,692,1
1588910400.0,1,0.0,0,9,1224,1233,1
1588910400.0,1,0.0,0,11,602,613,1
1588910400.0,1,0.0,0,4,602,606,1
1588910400.0,1,0.0,0,11,80,91,1
1588910400.0,1,0.0,0,11,350,361,1
1588910400.0,2,1.0,1,10,431,441,1
1588910400.0,0,0.0,0,8,646,654,0
1588910400.0,0,0.0,0,10,2236,2246,0
1588910400.0,1,8.0,8,13,233,246,1
1588910400.0,0,0.0,0,12,935,947,0
1588910400.0,1,0.0,0,20,791,811,1
1588910400.0,2,4.5,4,15,701,716,1
1588910400.0,1,1.0,1,9,270,279,1
1588910400.0,2,1.0,1,12,479,491,1
1588910400.0,0,0.0,0,11,1095,1106,1
1588910400.0,1,1.0,1,10,824,834,1
1588910400.0,1,1.0,1,14,749,763,1
1588910400.0,1,0.0,0,18,791,809,1
1588910400.0,0,0.0,0,10,829,839,1
1588910400.0,3,2.6666666666666665,3,11,1086,1097,1
1588910400.0,1,0.0,0,18,735,753,1
1588910400.0,1,0.0,0,10,311,321,1
1588910400.0,0,0.0,0,17,515,532,1
1588910400.0,1,0.0,0,10,1080,1090,1
1588910400.0,0,0.0,0,8,289,297,1
1588910400.0,1,3.0,3,12,723,735,1
1588910400.0,1,0.0,0,17,1029,1046,1
1588910400.0,1,0.0,0,16,1033,1049,1
1588910400.0,2,1.0,1,9,2640,2649,1
1588910400.0,1,0.0,0,15,1043,1058,1
1588910400.0,1,0.0,0,11,432,443,1
1588910400.0,0,0.0,0,7,579,586,1
1588910400.0,1,0.0,0,11,823,834,1
1588996800.0,1,0.0,0,12,828,840,1
1588996800.0,1,0.0,0,13,2176,2189,1
1588996800.0,1,8.0,8,7,228,235,1
1588996800.0,2,1.0,1,11,3761,3772,1
1588996800.0,2,1.0,1,8,813,821,1
1588996800.0,0,0.0,0,13,993,1006,1
1588996800.0,1,8.0,8,13,734,747,1
1588996800.0,1,0.0,0,5,433,438,1
1589083200.0,0,0.0,0,12,2113,2125,1
1589083200.0,1,0.0,0,10,1715,1725,1
1589083200.0,0,0.0,0,25,1659,1684,1
1589083200.0,0,0.0,0,14,278,292,1
1589083200.0,0,0.0,0,11,1071,1082,1
1589083200.0,0,0.0,0,9,955,964,1
1589083200.0,1,3.0,3,16,396,412,1
1589083200.0,0,0.0,0,10,665,675,1
1589083200.0,1,0.0,0,16,347,363,1
1589083200.0,1,0.0,0,12,730,742,1
1589083200.0,1,0.0,0,8,187,195,1
1589083200.0,1,0.0,0,13,259,272,1
1589083200.0,2,1.5,1,10,635,645,1
1589083200.0,1,0.0,0,15,699,714,1
1589083200.0,1,0.0,0,10,65,75,1
1589083200.0,2,4.5,4,19,1214,1233,1
1589083200.0,1,0.0,0,10,588,598,1
1589083200.0,0,0.0,0,10,378,388,1
1589083200.0,1,0.0,0,14,483,497,1
1589083200.0,1,0.0,0,17,332,349,1
1589083200.0,0,0.0,0,9,2388,2397,1
1589169600.0,1,0.0,0,10,362,372,1
1589169600.0,0,0.0,0,17,1887,1904,1
1589169600.0,1,0.0,0,11,67,78,1
1589169600.0,2,1.0,1,12,1939,1951,1
1589169600.0,3,4.0,2,11,1262,1273,1
1589169600.0,0,0.0,0,10,1173,1183,1
1589169600.0,0,0.0,0,17,1607,1624,1
1589169600.0,0,0.0,0,15,663,678,1
1589169600.0,0,0.0,0,11,537,548,1
1589169600.0,0,0.0,0,11,740,751,1
1589169600.0,0,0.0,0,12,721,733,1
1589169600.0,1,0.0,0,11,96,107,1
1589169600.0,1,3.0,3,12,740,752,1
1589169600.0,1,0.0,0,5,786,791,1
1589169600.0,2,1.0,1,16,789,805,1
1589169600.0,2,1.0,1,12,1211,1223,1
1589169600.0,0,0.0,0,22,745,767,1
1589169600.0,1,8.0,8,10,199,209,1
1589169600.0,1,0.0,0,12,691,703,1
1589169600.0,0,0.0,0,8,32,40,1
1589169600.0,1,0.0,0,14,800,814,1
1589169600.0,1,3.0,3,17,499,516,1
1589169600.0,1,0.0,0,10,699,709,1
1589169600.0,1,3.0,3,17,934,951,1
1589169600.0,1,0.0,0,12,199,211,1
1589169600.0,1,0.0,0,13,1046,1059,1
1589169600.0,1,1.0,1,21,865,886,1
1589169600.0,1,3.0,3,11,489,500,1
1589169600.0,0,0.0,0,5,871,876,1
1589169600.0,2,1.0,1,15,636,651,1
1589169600.0,1,0.0,0,13,188,201,1
1589169600.0,1,1.0,1,14,137,151,1
1589169600.0,1,1.0,1,7,293,300,1
1589169600.0,1,0.0,0,11,2038,2049,1
1589169600.0,1,0.0,0,11,436,447,1
1589169600.0,0,0.0,0,10,551,561,1
1589256000.0,0,0.0,0,9,329,338,1
1589256000.0,1,2.0,2,12,339,351,1
1589256000.0,0,0.0,0,11,794,805,1
1589256000.0,3,4.333333333333333,5,9,997,1006,1
1589256000.0,0,0.0,0,10,809,819,1
1589256000.0,1,0.0,0,4,1260,1264,1
1589256000.0,1,8.0,8,12,253,265,1
1589256000.0,1,0.0,0,12,605,617,1
1589256000.0,1,0.0,0,12,822,834,1
1589256000.0,4,3.0,3,9,3199,3208,1
1589256000.0,0,0.0,0,11,483,494,1
1589256000.0,0,0.0,0,7,604,611,1
1589256000.0,0,0.0,0,12,377,389,1
1589256000.0,2,1.0,1,15,1186,1201,1
1589256000.0,1,0.0,0,15,1742,1757,1
1589256000.0,1,0.0,0,10,560,570,1
1589256000.0,0,0.0,0,9,274,283,1
1589256000.0,1,0.0,0,12,479,491,1
1589256000.0,1,8.0,8,10,321,331,1
1589256000.0,0,0.0,0,12,577,589,0
1589256000.0,1,0.0,0,17,989,1006,1
1589256000.0,1,0.0,0,13,7328,7341,1
1589256000.0,2,1.5,1,10,316,326,1
1589256000.0,1,0.0,0,5,473,478,1
1589256000.0,1,2.0,2,14,392,406,1
1589256000.0,1,3.0,3,13,383,396,1
1589256000.0,1,0.0,0,14,252,266,1
1589256000.0,1,1.0,1,13,430,443,1
1589256000.0,2,1.5,1,14,660,674,1
1589256000.0,1,0.0,0,33,2245,2278,1
1589256000.0,1,9.0,9,13,1731,1744,1
1589256000.0,1,0.0,0,18,200,218,1
1589256000.0,1,0.0,0,13,596,609,1
1589256000.0,1,0.0,0,5,549,554,1
1589256000.0,2,4.5,4,11,1058,1069,1
1589256000.0,0,0.0,0,15,6585,6600,1
1589256000.0,0,0.0,0,10,98,108,1
1589256000.0,0,0.0,0,10,408,418,1
1589256000.0,0,0.0,0,10,238,248,1
1589256000.0,1,1.0,1,22,759,781,1
1589256000.0,1,3.0,3,18,626,644,1
1589256000.0,2,1.0,1,9,1991,2000,1
1589256000.0,1,0.0,0,13,597,610,1
1589256000.0,1,0.0,0,15,618,633,1
1589256000.0,0,0.0,0,10,838,848,1
1589256000.0,1,0.0,0,8,1393,1401,1
1589342400.0,1,0.0,0,15,1005,1020,1
1589342400.0,1,0.0,0,8,1279,1287,1
1589342400.0,1,0.0,0,9,1137,1146,1
1589342400.0,1,0.0,0,8,1628,1636,1
1589342400.0,0,0.0,0,11,543,554,1
1589342400.0,1,0.0,0,8,1291,1299,1
1589342400.0,1,0.0,0,9,1058,1067,1
1589342400.0,0,0.0,0,11,508,519,1
1589342400.0,1,0.0,0,6,551,557,1
1589342400.0,1,0.0,0,9,3731,3740,1
1589342400.0,2,1.0,1,6,379,385,1
1589342400.0,1,0.0,0,5,1021,1026,1
1589342400.0,0,0.0,0,7,143,150,1
1589342400.0,2,0.0,0,6,807,813,1
1589342400.0,0,0.0,0,11,542,553,1
1589342400.0,0,0.0,0,11,575,586,1
1589342400.0,1,0.0,0,15,460,475,1
1589342400.0,1,2.0,2,10,606,616,1
1589342400.0,2,1.0,1,17,401,418,1
1589342400.0,1,0.0,0,31,815,846,1
1589342400.0,1,0.0,0,27,137,164,1
1589342400.0,1,0.0,0,16,1719,1735,1
1589342400.0,1,0.0,0,17,744,761,1
1589342400.0,1,0.0,0,18,400,418,1
1589342400.0,1,2.0,2,22,288,310,1
1589342400.0,1,0.0,0,8,1103,1111,1
1589342400.0,0,0.0,0,14,592,606,1
1589342400.0,1,0.0,0,16,1578,1594,1
1589342400.0,1,0.0,0,38,676,714,1
1589342400.0,1,0.0,0,15,1420,1435,1
1589342400.0,1,0.0,0,12,1457,1469,1
1589342400.0,1,8.0,8,10,2028,2038,1
1589342400.0,2,1.0,1,14,2170,2184,1
1589342400.0,1,0.0,0,9,550,559,1
1589342400.0,1,2.0,2,12,516,528,1
1589342400.0,1,0.0,0,9,1687,1696,1
1589342400.0,1,9.0,9,13,441,454,1
1589342400.0,0,0.0,0,9,623,632,1
1589342400.0,1,0.0,0,13,359,372,1
1589342400.0,1,0.0,0,8,804,812,1
1589342400.0,2,1.0,1,8,1640,1648,1
1589342400.0,1,0.0,0,8,2353,2361,1
1589342400.0,0,0.0,0,11,828,839,0
1589342400.0,0,0.0,0,9,740,749,0
1589342400.0,1,2.0,2,20,439,459,1
1589342400.0,1,0.0,0,8,374,382,1
1589342400.0,2,1.5,1,17,1289,1306,1
1589342400.0,1,3.0,3,24,670,694,1
1589342400.0,1,0.0,0,10,1259,1269,1
1589428800.0,1,0.0,0,12,657,669,1
1589428800.0,1,0.0,0,10,830,840,1
1589428800.0,0,0.0,0,18,536,554,1
1589428800.0,1,1.0,1,11,961,972,1
1589428800.0,1,0.0,0,12,1573,1585,1
1589428800.0,1,8.0,8,8,308,316,1
1589428800.0,0,0.0,0,8,563,571,1
1589428800.0,2,1.0,1,6,753,759,1
1589428800.0,1,0.0,0,13,507,520,1
1589428800.0,1,0.0,0,14,1063,1077,1
1589428800.0,1,8.0,8,15,299,314,1
1589428800.0,1,0.0,0,17,306,323,1
1589428800.0,1,0.0,0,18,472,490,1
1589428800.0,1,0.0,0,13,424,437,1
1589428800.0,0,0.0,0,11,645,656,1
1589428800.0,0,0.0,0,12,352,364,1
1589428800.0,1,0.0,0,15,461,476,1
1589428800.0,1,0.0,0,12,752,764,1
1589428800.0,1,0.0,0,7,1135,1142,1
1589428800.0,1,0.0,0,4,1486,1490,1
1589428800.0,0,0.0,0,13,2245,2258,1
1589428800.0,0,0.0,0,19,718,737,1
1589428800.0,1,0.0,0,14,962,976,1
1589428800.0,1,0.0,0,17,1229,1246,1
1589428800.0,0,0.0,0,9,675,684,1
1589428800.0,0,0.0,0,11,2828,2839,1
1589428800.0,0,0.0,0,10,621,631,1
1589428800.0,1,0.0,0,9,1294,1303,1
1589428800.0,1,0.0,0,15,690,705,1
1589428800.0,2,1.0,1,7,453,460,1
1589428800.0,0,0.0,0,14,1081,1095,1
1589428800.0,0,0.0,0,7,675,682,1
1589428800.0,0,0.0,0,10,518,528,1
1589428800.0,2,1.0,1,12,1223,1235,1
1589428800.0,1,0.0,0,20,687,707,1
1589428800.0,1,8.0,8,11,505,516,1
1589428800.0,1,0.0,0,13,959,972,1
1589428800.0,1,0.0,0,18,222,240,1
1589428800.0,1,0.0,0,13,311,324,1
1589428800.0,2,1.0,1,15,177,192,1
1589428800.0,1,0.0,0,18,616,634,1
1589428800.0,2,2.5,2,13,265,278,1
1589428800.0,1,0.0,0,7,501,508,1
1589428800.0,1,0.0,0,13,293,306,1
1589428800.0,2,1.0,1,10,602,612,1
1589428800.0,1,0.0,0,22,384,406,1
1589428800.0,1,0.0,0,14,803,817,1
1589428800.0,1,0.0,0,13,332,345,1
1589428800.0,1,0.0,0,9,1077,1086,1
1589428800.0,1,1.0,1,12,650,662,1
1589428800.0,1,0.0,0,18,1044,1062,1
1589428800.0,1,0.0,0,23,101,124,1
1589428800.0,1,0.0,0,27,364,391,1
1589428800.0,1,0.0,0,28,1172,1200,1
1589428800.0,1,0.0,0,17,341,358,1
1589428800.0,1,1.0,1,17,575,592,1
1589428800.0,1,2.0,2,12,1134,1146,1
1589428800.0,1,0.0,0,19,659,678,1
1589428800.0,1,1.0,1,7,756,763,1
1589428800.0,2,1.5,1,11,365,376,1
1589428800.0,1,0.0,0,15,451,466,1
1589428800.0,1,0.0,0,27,763,790,1
1589428800.0,0,0.0,0,10,830,840,1
1589428800.0,2,1.5,1,10,890,900,1
1589428800.0,1,0.0,0,32,526,558,1
1589428800.0,1,0.0,0,12,348,360,1
1589428800.0,1,0.0,0,23,405,428,1
1589428800.0,1,0.0,0,10,602,612,1
1589428800.0,2,4.5,4,19,1047,1066,1
1589428800.0,1,0.0,0,15,441,456,1
1589428800.0,1,3.0,3,16,423,439,1
1589428800.0,1,3.0,3,12,634,646,1
1589428800.0,0,0.0,0,8,225,233,1
1589428800.0,1,0.0,0,16,142,158,1
1589428800.0,1,0.0,0,11,644,655,1
1589428800.0,0,0.0,0,9,910,919,1
1589428800.0,1,0.0,0,6,602,608,1
1589428800.0,1,0.0,0,22,516,538,1
1589428800.0,1,0.0,0,11,718,729,1
1589515200.0,1,1.0,1,11,472,483,1
1589515200.0,3,2.0,2,16,959,975,1
1589515200.0,1,2.0,2,16,352,368,1
1589515200.0,1,0.0,0,25,1168,1193,1
1589515200.0,1,0.0,0,10,1151,1161,1
1589515200.0,1,8.0,8,7,946,953,1
1589515200.0,2,1.0,1,20,1768,1788,1
1589515200.0,1,8.0,8,12,294,306,1
1589515200.0,1,1.0,1,17,586,603,1
1589515200.0,1,0.0,0,24,335,359,1
1589515200.0,1,1.0,1,27,735,762,1
1589515200.0,1,8.0,8,12,253,265,1
1589515200.0,1,0.0,0,22,1086,1108,1
1589515200.0,1,0.0,0,11,570,581,1
1589515200.0,1,0.0,0,16,462,478,1
1589515200.0,1,0.0,0,16,538,554,1
1589515200.0,1,1.0,1,23,719,742,1
1589515200.0,1,0.0,0,17,959,976,1
1589515200.0,1,0.0,0,10,589,599,1
1589515200.0,3,2.0,2,8,100,108,1
1589515200.0,1,0.0,0,10,764,774,1
1589515200.0,1,0.0,0,12,798,810,1
1589515200.0,1,0.0,0,17,1489,1506,1
1589515200.0,1,1.0,1,30,1205,1235,1
1589515200.0,1,0.0,0,9,575,584,1
1589515200.0,2,1.0,1,17,586,603,1
1589515200.0,1,0.0,0,21,262,283,1
1589515200.0,1,1.0,1,22,621,643,1
1589515200.0,1,0.0,0,20,461,481,1
1589515200.0,1,0.0,0,12,605,617,1
1589515200.0,1,0.0,0,11,323,334,1
1589515200.0,1,0.0,0,11,978,989,1
1589515200.0,1,0.0,0,32,283,315,1
1589515200.0,1,0.0,0,19,763,782,1
1589515200.0,1,0.0,0,19,124,143,1
1589515200.0,2,1.5,1,12,408,420,1
1589515200.0,1,0.0,0,30,411,441,1
1589515200.0,3,2.0,2,16,550,566,1
1589515200.0,2,1.0,1,16,1113,1129,1
1589515200.0,2,1.0,1,11,2405,2416,1
1589515200.0,1,1.0,1,14,980,994,1
1589515200.0,1,0.0,0,20,710,730,1
1589515200.0,1,0.0,0,30,1059,1089,1
1589515200.0,1,0.0,0,12,135,147,1
1589515200.0,1,0.0,0,12,468,480,1
1589515200.0,1,0.0,0,21,702,723,1
1589515200.0,1,0.0,0,10,449,459,1
1589515200.0,2,1.5,1,13,565,578,1
1589515200.0,1,0.0,0,8,602,610,1
1589515200.0,1,0.0,0,15,2158,2173,1
1589515200.0,2,1.0,1,9,741,750,1
1589515200.0,1,0.0,0,7,629,636,1
1589515200.0,1,0.0,0,11,802,813,1
1589515200.0,1,0.0,0,5,612,617,1
1589515200.0,1,3.0,3,12,2189,2201,1
1589515200.0,1,0.0,0,14,674,688,1
1589515200.0,1,0.0,0,16,376,392,1
1589515200.0,1,0.0,0,11,1307,1318,1
1589515200.0,1,0.0,0,18,759,777,1
1589515200.0,1,0.0,0,7,727,734,1
1589515200.0,1,0.0,0,10,805,815,1
1589515200.0,1,0.0,0,13,188,201,1
1589515200.0,0,0.0,0,8,752,760,1
1589515200.0,1,0.0,0,25,917,942,1
1589515200.0,2,1.0,1,14,1460,1474,1
1589515200.0,1,0.0,0,12,577,589,1
1589515200.0,1,0.0,0,19,716,735,1
1589515200.0,1,0.0,0,11,453,464,1
1589515200.0,0,0.0,0,12,326,338,1
1589515200.0,1,0.0,0,14,372,386,1
1589515200.0,1,0.0,0,6,590,596,1
1589515200.0,1,0.0,0,14,504,518,1
1589515200.0,1,0.0,0,7,409,416,1
1589515200.0,1,0.0,0,9,466,475,1
1589515200.0,1,0.0,0,17,631,648,1
1589515200.0,1,0.0,0,26,417,443,1
1589515200.0,1,1.0,1,8,896,904,1
1589515200.0,1,0.0,0,6,508,514,1
1589515200.0,1,0.0,0,19,313,332,1
1589515200.0,2,1.0,1,17,1950,1967,1
1589515200.0,1,0.0,0,11,349,360,1
1589515200.0,1,0.0,0,8,1683,1691,1
1589515200.0,1,0.0,0,12,575,587,1
1589515200.0,1,0.0,0,11,639,650,1
1589515200.0,1,5.0,5,15,1894,1909,1
1589515200.0,1,0.0,0,13,1526,1539,1
1589515200.0,1,3.0,3,13,569,582,1
1589515200.0,1,0.0,0,11,1375,1386,1
1589515200.0,0,0.0,0,25,453,478,1
1589515200.0,2,1.0,1,13,955,968,1
1589515200.0,1,0.0,0,9,521,530,1
1589515200.0,1,0.0,0,18,439,457,1
1589515200.0,0,0.0,0,10,950,960,1
1589515200.0,1,0.0,0,11,410,421,1
1589515200.0,0,0.0,0,13,303,316,1
1589515200.0,0,0.0,0,15,327,342,1
1589515200.0,1,1.0,1,14,1627,1641,1
1589515200.0,1,0.0,0,14,950,964,1
1589515200.0,0,0.0,0,10,102,112,1
1589515200.0,1,1.0,1,10,284,294,1
1589515200.0,1,0.0,0,9,150,159,1
1589515200.0,1,0.0,0,10,667,677,1
1589515200.0,1,0.0,0,15,633,648,1
1589515200.0,1,0.0,0,18,392,410,1
1589515200.0,0,0.0,0,17,549,566,1
1589515200.0,1,0.0,0,12,216,228,1
1589515200.0,1,0.0,0,15,469,484,1
1589515200.0,1,1.0,1,12,785,797,1
1589515200.0,3,2.3333333333333335,2,10,1811,1821,1
1589515200.0,1,0.0,0,11,759,770,1
1589515200.0,1,0.0,0,11,1549,1560,1
1589515200.0,1,0.0,0,8,297,305,1
1589515200.0,1,0.0,0,7,722,729,1
1589515200.0,1,0.0,0,13,2875,2888,1
1589515200.0,1,0.0,0,14,413,427,1
1589515200.0,1,0.0,0,20,684,704,1
1589515200.0,1,3.0,3,11,628,639,1
1589515200.0,1,0.0,0,13,552,565,1
1589515200.0,1,2.0,2,10,331,341,1
1589515200.0,1,0.0,0,28,1253,1281,1
1589515200.0,1,10.0,10,12,2394,2406,1
1589515200.0,2,1.0,1,15,830,845,1
1589515200.0,1,1.0,1,26,523,549,1
1589515200.0,1,0.0,0,8,602,610,1
1589515200.0,1,0.0,0,9,1251,1260,1
1589515200.0,1,2.0,2,25,1186,1211,1
1589515200.0,1,0.0,0,12,868,880,1
1589515200.0,1,0.0,0,16,1050,1066,1
1589515200.0,1,0.0,0,6,961,967,1
1589515200.0,1,0.0,0,17,554,571,1
1589515200.0,2,1.5,1,15,552,567,1
1589515200.0,1,0.0,0,13,201,214,1
1589515200.0,1,0.0,0,17,170,187,1
1589515200.0,3,2.0,2,13,1758,1771,1
1589515200.0,1,0.0,0,11,569,580,1
1589515200.0,1,1.0,1,8,526,534,1
1589515200.0,1,0.0,0,13,736,749,1
1589515200.0,1,0.0,0,12,447,459,1
1589515200.0,1,0.0,0,8,642,650,1
1589515200.0,1,1.0,1,11,485,496,1
1589515200.0,1,0.0,0,9,374,383,1
1589515200.0,3,2.0,2,18,341,359,1
1589515200.0,1,0.0,0,16,1201,1217,1
1589515200.0,1,0.0,0,7,1919,1926,1
1589515200.0,1,2.0,2,6,602,608,1
1589515200.0,1,0.0,0,18,819,837,1
1589515200.0,1,0.0,0,19,1042,1061,1
1589515200.0,1,0.0,0,11,3403,3414,1
1589515200.0,0,0.0,0,4,602,606,1
1589515200.0,1,0.0,0,28,1088,1116,1
1589515200.0,0,0.0,0,12,224,236,1
1589515200.0,1,0.0,0,12,430,442,1
1589515200.0,1,0.0,0,18,412,430,1
1589515200.0,1,0.0,0,19,410,429,1
1589515200.0,1,0.0,0,12,1792,1804,1
1589515200.0,0,0.0,0,6,411,417,1
1589515200.0,1,0.0,0,12,417,429,1
1589515200.0,0,0.0,0,4,866,870,1
1589515200.0,1,0.0,0,7,1457,1464,1
1589515200.0,1,0.0,0,6,1274,1280,1
1589515200.0,0,0.0,0,24,1219,1243,1
1589515200.0,0,0.0,0,6,455,461,1
1589515200.0,1,0.0,0,14,872,886,1
1589515200.0,0,0.0,0,13,3924,3937,1
1589515200.0,1,0.0,0,23,1962,1985,1
1589515200.0,0,0.0,0,9,228,237,1
1589515200.0,1,0.0,0,14,465,479,1
1589515200.0,1,0.0,0,10,837,847,1
1589515200.0,1,0.0,0,9,314,323,1
1589515200.0,0,0.0,0,14,332,346,1
1589515200.0,2,1.0,1,11,335,346,1
1589515200.0,0,0.0,0,12,501,513,1
1589515200.0,1,0.0,0,5,633,638,1
1589515200.0,2,1.0,1,15,995,1010,1
1589601600.0,1,0.0,0,1,1074,1075,1
1589601600.0,1,0.0,0,4,1193,1197,1
1589601600.0,1,0.0,0,6,1272,1278,1
1589601600.0,1,0.0,0,10,1851,1861,1
1589601600.0,1,0.0,0,4,1070,1074,1
1589601600.0,1,0.0,0,14,959,973,1
1589601600.0,1,0.0,0,10,1968,1978,1
1589601600.0,1,0.0,0,19,525,544,1
1589601600.0,4,3.25,3,9,12528,12537,1
1589601600.0,1,0.0,0,8,25,33,1
1589601600.0,1,0.0,0,21,637,658,1
1589601600.0,2,1.5,1,8,2273,2281,1
1589601600.0,1,0.0,0,11,314,325,1
1589601600.0,0,0.0,0,12,334,346,1
1589601600.0,1,0.0,0,15,796,811,1
1589601600.0,0,0.0,0,20,345,365,1
1589601600.0,1,0.0,0,10,560,570,1
1589601600.0,3,2.0,2,18,180,198,1
1589601600.0,1,0.0,0,21,175,196,1
1589601600.0,1,0.0,0,16,399,415,1
1589601600.0,2,1.0,1,11,316,327,1
1589601600.0,1,0.0,0,11,520,531,1
1589601600.0,1,2.0,2,13,499,512,1
1589601600.0,0,0.0,0,18,367,385,1
1589601600.0,1,0.0,0,11,1278,1289,1
1589601600.0,2,1.0,1,10,124,134,1
1589601600.0,1,0.0,0,13,300,313,1
1589601600.0,2,1.0,1,9,948,957,1
1589601600.0,1,0.0,0,11,654,665,1
1589601600.0,1,0.0,0,10,1246,1256,1
1589601600.0,1,0.0,0,11,853,864,1
1589601600.0,1,0.0,0,10,1537,1547,1
1589601600.0,1,0.0,0,17,4493,4510,1
1589601600.0,1,0.0,0,4,553,557,1
1589601600.0,1,0.0,0,6,602,608,1
1589601600.0,1,0.0,0,13,1245,1258,1
1589601600.0,1,0.0,0,20,226,246,1
1589601600.0,3,2.0,2,12,2146,2158,1
1589601600.0,1,0.0,0,20,276,296,1
1589601600.0,1,0.0,0,14,1587,1601,1
1589601600.0,2,1.0,1,14,657,671,1
1589601600.0,0,0.0,0,16,2725,2741,1
1589601600.0,1,0.0,0,19,2728,2747,1
1589601600.0,1,0.0,0,20,1078,1098,1
1589601600.0,1,0.0,0,18,445,463,1
1589601600.0,1,0.0,0,14,1138,1152,1
1589601600.0,1,0.0,0,29,490,519,1
1589601600.0,1,0.0,0,11,227,238,1
1589601600.0,0,0.0,0,9,1101,1110,1
1589601600.0,1,0.0,0,18,590,608,1
1589601600.0,1,0.0,0,15,567,582,1
1589601600.0,1,0.0,0,12,808,820,1
1589601600.0,0,0.0,0,6,273,279,1
1589601600.0,2,1.0,1,11,597,608,1
1589601600.0,2,1.0,1,16,1483,1499,1
1589601600.0,1,0.0,0,13,998,1011,1
1589601600.0,2,1.5,1,16,429,445,1
1589601600.0,2,1.0,1,9,1196,1205,1
1589601600.0,1,0.0,0,15,338,353,1
1589601600.0,0,0.0,0,23,853,876,1
1589601600.0,0,0.0,0,10,946,956,1
1589601600.0,1,0.0,0,22,814,836,1
1589601600.0,2,1.0,1,13,992,1005,1
1589601600.0,1,0.0,0,40,662,702,1
1589601600.0,1,0.0,0,10,619,629,1
1589601600.0,1,0.0,0,8,657,665,1
1589601600.0,1,0.0,0,16,1740,1756,1
1589601600.0,1,0.0,0,31,1174,1205,1
1589601600.0,1,0.0,0,13,241,254,1
1589601600.0,1,0.0,0,12,648,660,1
1589601600.0,1,2.0,2,10,517,527,1
1589601600.0,1,0.0,0,18,496,514,1
1589601600.0,1,0.0,0,20,486,506,1
1589601600.0,1,0.0,0,13,822,835,1
1589601600.0,1,0.0,0,29,942,971,1
1589601600.0,1,0.0,0,15,354,369,1
1589601600.0,1,0.0,0,31,1706,1737,1
1589601600.0,1,0.0,0,10,728,738,1
1589601600.0,3,2.0,2,13,806,819,1
1589601600.0,1,0.0,0,25,1406,1431,1
1589601600.0,1,0.0,0,11,469,480,1
1589601600.0,1,0.0,0,19,216,235,1
1589601600.0,1,0.0,0,16,505,521,1
1589601600.0,1,0.0,0,17,908,925,1
1589601600.0,1,1.0,1,11,1363,1374,1
1589601600.0,2,1.5,1,11,515,526,1
1589601600.0,1,0.0,0,8,1270,1278,1
1589601600.0,1,0.0,0,27,1616,1643,1
1589601600.0,3,2.0,2,21,346,367,1
1589601600.0,1,2.0,2,21,736,757,1
1589601600.0,1,0.0,0,10,872,882,1
1589601600.0,1,0.0,0,23,280,303,1
1589601600.0,1,0.0,0,9,963,972,1
1589601600.0,2,1.5,1,10,2062,2072,1
1589601600.0,1,0.0,0,19,155,174,1
1589688000.0,1,0.0,0,14,4074,4088,1
1589688000.0,4,3.0,3,13,1804,1817,1
1589688000.0,2,1.0,1,10,599,609,1
1589688000.0,2,1.0,1,7,122,129,1
1589688000.0,1,0.0,0,15,548,563,1
1589688000.0,1,0.0,0,13,1482,1495,1
1589688000.0,1,0.0,0,8,86,94,1
1589688000.0,0,0.0,0,10,238,248,1
1589688000.0,2,1.0,1,15,1046,1061,1
1589688000.0,1,0.0,0,7,577,584,1
1589688000.0,0,0.0,0,11,445,456,1
1589688000.0,1,0.0,0,16,1969,1985,1
1589688000.0,1,0.0,0,15,842,857,1
1589688000.0,1,0.0,0,10,1146,1156,1
1589688000.0,1,0.0,0,9,613,622,1
1589688000.0,2,1.0,1,13,312,325,1
1589688000.0,1,8.0,8,12,240,252,1
1589688000.0,1,0.0,0,18,2245,2263,1
1589688000.0,1,1.0,1,12,545,557,1
1589688000.0,0,0.0,0,9,106,115,1
1589688000.0,1,0.0,0,13,333,346,1
1589688000.0,1,0.0,0,12,490,502,1
1589688000.0,1,0.0,0,7,970,977,1
1589688000.0,0,0.0,0,12,881,893,1
1589688000.0,1,0.0,0,15,871,886,1
1589688000.0,1,0.0,0,15,1331,1346,1
1589688000.0,1,0.0,0,16,1419,1435,1
1589688000.0,1,0.0,0,6,602,608,1
1589688000.0,1,0.0,0,12,1117,1129,1
1589688000.0,1,0.0,0,10,602,612,1
1589688000.0,2,1.0,1,12,1442,1454,1
1589688000.0,1,0.0,0,11,1068,1079,1
1589688000.0,1,0.0,0,16,1038,1054,1
1589688000.0,0,0.0,0,5,642,647,1
1589688000.0,1,0.0,0,2,1296,1298,1
1589688000.0,0,0.0,0,10,320,330,1
1589688000.0,1,0.0,0,12,349,361,1
1589688000.0,0,0.0,0,12,96,108,1
1589688000.0,1,0.0,0,3,904,907,1
1589688000.0,1,0.0,0,15,307,322,1
1589688000.0,0,0.0,0,27,1049,1076,1
1589688000.0,1,0.0,0,11,425,436,1
1589774400.0,2,1.0,1,13,633,646,1
1589774400.0,1,0.0,0,10,1879,1889,1
1589774400.0,1,0.0,0,7,635,642,1
1589774400.0,1,0.0,0,16,346,362,1
1589774400.0,0,0.0,0,8,353,361,1
1589774400.0,1,8.0,8,12,261,273,1
1589774400.0,1,0.0,0,9,602,611,1
1589774400.0,2,1.0,1,14,806,820,1
1589774400.0,1,0.0,0,12,761,773,1
1589774400.0,1,0.0,0,14,736,750,1
1589774400.0,3,1.0,1,15,772,787,1
1589774400.0,0,0.0,0,10,635,645,1
1589774400.0,1,0.0,0,11,779,790,1
1589774400.0,1,0.0,0,14,508,522,1
1589774400.0,1,0.0,0,7,374,381,1
1589774400.0,1,1.0,1,20,1182,1202,1
1589774400.0,1,0.0,0,12,1008,1020,1
1589774400.0,1,0.0,0,11,358,369,1
1589774400.0,1,0.0,0,9,1614,1623,1
1589774400.0,1,0.0,0,15,1033,1048,1
1589774400.0,1,0.0,0,15,266,281,1
1589774400.0,2,1.0,1,13,1507,1520,1
1589774400.0,1,0.0,0,6,602,608,1
1589774400.0,2,1.0,1,13,512,525,1
1589774400.0,0,0.0,0,12,228,240,1
1589774400.0,2,1.0,1,9,761,770,1
1589774400.0,0,0.0,0,8,332,340,1
1589774400.0,1,0.0,0,13,1173,1186,1
1589774400.0,1,0.0,0,21,369,390,1
1589774400.0,1,0.0,0,13,602,615,1
1589774400.0,1,0.0,0,14,602,616,1
1589774400.0,0,0.0,0,6,95,101,1
1589774400.0,0,0.0,0,11,346,357,1
1589774400.0,1,0.0,0,19,506,525,1
1589774400.0,1,0.0,0,13,1105,1118,1
1589774400.0,1,0.0,0,16,401,417,1
1589774400.0,1,0.0,0,12,332,344,1
1589774400.0,1,0.0,0,6,895,901,1
1589774400.0,2,2.0,2,8,602,610,1
1589774400.0,3,2.0,2,11,752,763,1
1589774400.0,1,0.0,0,13,661,674,1
1589774400.0,0,0.0,0,9,679,688,1
1589774400.0,1,0.0,0,6,500,506,1
1589774400.0,0,0.0,0,7,1121,1128,1
1589774400.0,1,0.0,0,10,423,433,1
1589774400.0,2,1.0,1,9,993,1002,1
1589774400.0,3,2.0,2,12,1777,1789,1
1589774400.0,1,0.0,0,4,377,381,1
1589774400.0,1,2.0,2,12,430,442,1
1589774400.0,1,0.0,0,14,591,605,1
1589774400.0,0,0.0,0,11,399,410,1
1589774400.0,1,8.0,8,10,436,446,1
1589774400.0,2,1.0,1,10,602,612,1
1589774400.0,1,0.0,0,7,602,609,1
1589774400.0,1,0.0,0,13,737,750,1
1589774400.0,2,1.0,1,9,602,611,1
1589774400.0,1,0.0,0,6,563,569,1
1589774400.0,1,0.0,0,12,1491,1503,1
1589774400.0,0,0.0,0,11,306,317,1
1589774400.0,0,0.0,0,22,670,692,1
1589774400.0,1,0.0,0,10,280,290,1
1589774400.0,1,0.0,0,16,1022,1038,1
1589774400.0,1,0.0,0,9,272,281,1
1589774400.0,1,1.0,1,14,856,870,1
1589774400.0,0,0.0,0,11,96,107,1
1589774400.0,1,0.0,0,7,4022,4029,1
1589774400.0,1,0.0,0,15,562,577,1
1589774400.0,0,0.0,0,13,604,617,1
1589774400.0,0,0.0,0,7,535,542,1
1589774400.0,1,1.0,1,6,1971,1977,1
1589774400.0,2,1.0,1,7,1256,1263,1
1589774400.0,1,0.0,0,13,178,191,1
1589774400.0,1,0.0,0,9,1423,1432,1
1589774400.0,1,0.0,0,13,625,638,1
1589774400.0,0,0.0,0,7,444,451,1
1589774400.0,0,0.0,0,18,240,258,1
1589774400.0,0,0.0,0,13,759,772,1
1589774400.0,1,0.0,0,12,125,137,1
1589774400.0,0,0.0,0,22,4414,4436,1
1589774400.0,0,0.0,0,15,935,950,1
1589774400.0,0,0.0,0,4,1808,1812,1
1589774400.0,0,0.0,0,12,545,557,1
1589774400.0,0,0.0,0,11,993,1004,1
1589774400.0,1,0.0,0,4,1192,1196,1
1589774400.0,1,0.0,0,13,1663,1676,1
1589774400.0,0,0.0,0,13,241,254,1
1589774400.0,1,0.0,0,14,866,880,1
1589774400.0,1,0.0,0,15,1070,1085,1
1589774400.0,1,0.0,0,18,46,64,1
1589774400.0,1,0.0,0,13,291,304,1
1589774400.0,1,0.0,0,9,398,407,1
1589774400.0,1,0.0,0,12,27,39,1
1589774400.0,1,0.0,0,10,742,752,1
1589774400.0,1,0.0,0,9,84,93,1
1589774400.0,1,0.0,0,15,1368,1383,1
1589774400.0,1,1.0,1,15,863,878,1
1589774400.0,1,0.0,0,9,492,501,1
1589774400.0,3,2.0,2,14,2834,2848,1
1589774400.0,1,0.0,0,12,936,948,1
1589774400.0,1,0.0,0,8,583,591,1
1589774400.0,3,2.0,2,14,912,926,1
1589774400.0,5,4.0,4,14,102,116,1
1589774400.0,1,1.0,1,13,657,670,1
1589774400.0,1,0.0,0,20,1921,1941,1
1589774400.0,1,0.0,0,7,947,954,1
1589860800.0,0,0.0,0,18,1209,1227,1
1589860800.0,1,0.0,0,10,842,852,1
1589860800.0,1,0.0,0,13,434,447,1
1589860800.0,0,0.0,0,14,96,110,1
1589860800.0,1,0.0,0,4,1426,1430,1
1589860800.0,0,0.0,0,11,1054,1065,1
1589860800.0,0,0.0,0,8,40,48,1
1589860800.0,1,0.0,0,11,191,202,1
1589860800.0,1,0.0,0,9,93,102,1
1589860800.0,0,0.0,0,11,1229,1240,1
1589860800.0,1,0.0,0,5,1544,1549,1
1589860800.0,0,0.0,0,9,225,234,1
1589860800.0,1,0.0,0,11,1211,1222,1
1589860800.0,1,1.0,1,11,944,955,1
1589860800.0,0,0.0,0,7,28,35,1
1589860800.0,1,0.0,0,8,1068,1076,1
1589860800.0,1,0.0,0,7,1234,1241,1
1589860800.0,0,0.0,0,8,806,814,1
1589860800.0,0,0.0,0,13,638,651,1
1589860800.0,1,0.0,0,7,1431,1438,1
1589860800.0,1,0.0,0,11,449,460,1
1589860800.0,3,2.0,2,11,692,703,1
1589860800.0,1,0.0,0,13,375,388,1
1589860800.0,1,0.0,0,13,965,978,1
1589860800.0,1,0.0,0,11,666,677,1
1589860800.0,1,0.0,0,12,593,605,1
1589860800.0,1,0.0,0,15,1136,1151,1
1589860800.0,2,1.0,1,20,353,373,1
1589860800.0,1,0.0,0,15,184,199,1
1589860800.0,1,0.0,0,10,941,951,1
1589860800.0,1,0.0,0,16,775,791,1
1589860800.0,1,0.0,0,12,385,397,1
1589860800.0,0,0.0,0,11,408,419,1
1589860800.0,1,0.0,0,12,824,836,1
1589860800.0,1,0.0,0,15,1948,1963,1
1589860800.0,1,0.0,0,14,435,449,1
1589860800.0,2,1.0,1,15,1124,1139,1
1589860800.0,2,1.0,1,17,365,382,1
1589860800.0,1,0.0,0,10,319,329,1
1589860800.0,1,0.0,0,12,356,368,1
1589860800.0,1,0.0,0,10,244,254,1
1589860800.0,0,0.0,0,10,442,452,1
1589860800.0,1,0.0,0,10,217,227,1
1589860800.0,3,2.0,2,9,875,884,1
1589860800.0,2,1.0,1,8,7544,7552,1
1589860800.0,1,0.0,0,12,1535,1547,1
1589860800.0,0,0.0,0,15,477,492,1
1589860800.0,1,0.0,0,13,435,448,1
1589860800.0,1,0.0,0,9,755,764,1
1589860800.0,1,0.0,0,11,332,343,1
1589860800.0,1,0.0,0,11,332,343,1
1589860800.0,0,0.0,0,9,180,189,1
1589860800.0,2,1.0,1,11,568,579,1
1589860800.0,1,0.0,0,12,302,314,1
1589860800.0,0,0.0,0,8,505,513,1
1589860800.0,0,0.0,0,11,239,250,1
1589860800.0,2,1.0,1,12,294,306,1
1589860800.0,0,0.0,0,12,128,140,1
1589860800.0,0,0.0,0,13,93,106,1
1589860800.0,1,0.0,0,9,1006,1015,1
1589860800.0,1,0.0,0,8,879,887,1
1589860800.0,1,0.0,0,14,238,252,1
1589860800.0,1,0.0,0,11,778,789,1
1589860800.0,1,0.0,0,10,683,693,1
1589860800.0,1,0.0,0,14,661,675,1
1589860800.0,3,2.0,2,11,1832,1843,1
1589860800.0,1,0.0,0,20,1566,1586,1
1589860800.0,2,2.0,2,16,1339,1355,1
1589860800.0,1,0.0,0,11,648,659,1
1589860800.0,1,0.0,0,8,962,970,1
1589860800.0,3,2.3333333333333335,2,13,1003,1016,1
1589860800.0,1,0.0,0,9,815,824,1
1589860800.0,1,0.0,0,11,696,707,1
1589860800.0,1,0.0,0,12,425,437,1
1589860800.0,0,0.0,0,9,173,182,1
1589860800.0,1,0.0,0,14,541,555,1
1589860800.0,0,0.0,0,7,449,456,1
1589860800.0,1,0.0,0,12,732,744,1
1589860800.0,1,0.0,0,10,483,493,1
1589860800.0,0,0.0,0,12,340,352,1
1589860800.0,0,0.0,0,9,324,333,1
1589860800.0,2,1.0,1,11,362,373,1
1589860800.0,0,0.0,0,8,202,210,1
1589860800.0,1,0.0,0,9,379,388,1
1589860800.0,3,2.0,2,13,1010,1023,1
1589860800.0,2,1.0,1,10,447,457,1
1589860800.0,1,0.0,0,11,772,783,1
1589860800.0,1,0.0,0,10,467,477,1
1589860800.0,3,2.0,2,9,303,312,1
1589860800.0,0,0.0,0,9,363,372,1
1589860800.0,1,0.0,0,18,467,485,1
1589860800.0,1,0.0,0,12,520,532,1
1589860800.0,1,0.0,0,7,105,112,1
1589860800.0,0,0.0,0,11,624,635,1
1589860800.0,0,0.0,0,7,173,180,1
1589860800.0,2,1.0,1,13,412,425,1
1589860800.0,0,0.0,0,10,239,249,1
1589860800.0,2,1.0,1,12,227,239,1
1589860800.0,0,0.0,0,12,228,240,1
1589860800.0,0,0.0,0,6,889,895,1
1589860800.0,0,0.0,0,6,55,61,1
1589860800.0,1,0.0,0,5,602,607,1
1589860800.0,1,0.0,0,20,522,542,1
1589860800.0,1,0.0,0,13,595,608,1
1589860800.0,1,0.0,0,9,535,544,1
1589860800.0,1,0.0,0,11,492,503,1
1589860800.0,3,2.0,2,12,769,781,1
1589860800.0,0,0.0,0,9,556,565,1
1589860800.0,2,1.0,1,10,875,885,1
1589860800.0,2,1.0,1,9,588,597,1
1589860800.0,1,0.0,0,10,880,890,1
1589860800.0,1,0.0,0,14,621,635,1
1589860800.0,1,0.0,0,18,675,693,1
1589860800.0,2,1.5,1,7,602,609,1
1589860800.0,1,0.0,0,11,469,480,1
1589860800.0,1,0.0,0,7,1099,1106,1
1589860800.0,1,0.0,0,9,766,775,1
1589860800.0,2,1.0,1,12,430,442,1
1589860800.0,1,0.0,0,18,227,245,1
1589860800.0,1,0.0,0,3,602,605,1
1589860800.0,1,0.0,0,12,602,614,1
1589860800.0,1,0.0,0,8,1510,1518,1
1589860800.0,1,0.0,0,7,602,609,1
1589860800.0,1,0.0,0,9,602,611,1
1589860800.0,1,0.0,0,9,602,611,1
1589860800.0,1,0.0,0,15,701,716,1
1589860800.0,0,0.0,0,10,269,279,1
1589860800.0,0,0.0,0,9,263,272,1
1589860800.0,0,0.0,0,11,214,225,1
1589860800.0,0,0.0,0,6,220,226,1
1589860800.0,0,0.0,0,9,218,227,1
1589860800.0,1,0.0,0,12,697,709,1
1589860800.0,1,0.0,0,16,1345,1361,1
1589860800.0,1,0.0,0,18,486,504,1
1589860800.0,1,0.0,0,12,1288,1300,1
1589860800.0,1,0.0,0,9,549,558,1
1589860800.0,1,0.0,0,10,1215,1225,1
1589860800.0,1,0.0,0,10,818,828,1
1589860800.0,1,0.0,0,11,780,791,1
1589860800.0,1,0.0,0,19,743,762,1
1589947200.0,1,0.0,0,16,1147,1163,1
1589947200.0,1,0.0,0,5,1010,1015,1
1589947200.0,1,0.0,0,11,368,379,1
1589947200.0,0,0.0,0,4,1072,1076,1
1589947200.0,0,0.0,0,5,689,694,1
1589947200.0,0,0.0,0,9,183,192,1
1589947200.0,1,0.0,0,10,346,356,1
1589947200.0,2,1.5,1,12,620,632,1
1589947200.0,1,0.0,0,10,181,191,1
1589947200.0,1,0.0,0,16,1251,1267,1
1589947200.0,1,2.0,2,10,454,464,1
1589947200.0,1,0.0,0,17,513,530,1
1589947200.0,1,0.0,0,15,546,561,1
1589947200.0,0,0.0,0,14,572,586,1
1589947200.0,1,0.0,0,14,387,401,1
1589947200.0,3,3.0,2,14,1550,1564,1
1589947200.0,1,0.0,0,19,735,754,1
1589947200.0,3,2.0,2,8,601,609,1
1589947200.0,1,0.0,0,15,263,278,1
1589947200.0,1,0.0,0,13,1000,1013,1
1589947200.0,2,1.0,1,10,313,323,1
1589947200.0,0,0.0,0,13,96,109,1
1589947200.0,1,0.0,0,20,1567,1587,1
1589947200.0,0,0.0,0,19,522,541,1
1589947200.0,0,0.0,0,11,353,364,1
1589947200.0,1,0.0,0,4,747,751,1
1589947200.0,1,0.0,0,9,850,859,1
1589947200.0,2,1.0,1,13,813,826,1
1589947200.0,1,0.0,0,12,781,793,1
1589947200.0,0,0.0,0,11,1092,1103,1
1589947200.0,0,0.0,0,8,133,141,1
1589947200.0,1,0.0,0,11,1268,1279,1
1589947200.0,1,0.0,0,15,1224,1239,1
1589947200.0,1,1.0,1,15,407,422,1
1589947200.0,0,0.0,0,14,354,368,1
1589947200.0,0,0.0,0,18,581,599,1
1589947200.0,0,0.0,0,13,466,479,1
1589947200.0,0,0.0,0,12,1229,1241,1
1589947200.0,1,0.0,0,12,228,240,1
1589947200.0,1,0.0,0,10,228,238,1
1589947200.0,0,0.0,0,12,309,321,1
1589947200.0,1,0.0,0,13,678,691,1
1589947200.0,1,0.0,0,13,344,357,1
1589947200.0,1,0.0,0,27,960,987,1
1589947200.0,2,1.0,1,9,411,420,1
1589947200.0,0,0.0,0,10,738,748,1
1589947200.0,1,0.0,0,24,655,679,1
1589947200.0,1,0.0,0,12,390,402,1
1589947200.0,4,3.5,3,12,1002,1014,1
1589947200.0,1,0.0,0,10,3094,3104,1
1589947200.0,0,0.0,0,9,1033,1042,1
1589947200.0,1,0.0,0,10,602,612,1
1589947200.0,1,0.0,0,9,409,418,1
1589947200.0,1,0.0,0,10,602,612,1
1589947200.0,1,0.0,0,7,602,609,1
1589947200.0,1,0.0,0,13,754,767,1
1589947200.0,0,0.0,0,13,916,929,1
1589947200.0,1,0.0,0,15,324,339,1
1589947200.0,1,0.0,0,10,543,553,1
1589947200.0,1,0.0,0,11,1188,1199,1
1589947200.0,1,0.0,0,13,1074,1087,1
1589947200.0,2,1.0,1,16,483,499,1
1589947200.0,2,1.0,1,10,790,800,1
1589947200.0,1,1.0,1,5,602,607,1
1589947200.0,0,0.0,0,12,128,140,1
1589947200.0,1,0.0,0,10,1393,1403,1
1589947200.0,1,0.0,0,11,602,613,1
1589947200.0,1,0.0,0,12,231,243,1
1589947200.0,1,0.0,0,9,672,681,1
1589947200.0,1,0.0,0,7,2454,2461,1
1589947200.0,1,0.0,0,12,273,285,1
1589947200.0,2,1.0,1,19,2231,2250,1
1589947200.0,1,0.0,0,12,554,566,1
1589947200.0,2,2.5,2,10,3205,3215,1
1589947200.0,2,1.0,1,13,635,648,1
1589947200.0,2,1.0,1,12,615,627,1
1589947200.0,3,2.3333333333333335,2,12,2456,2468,1
1589947200.0,2,1.0,1,24,520,544,1
1589947200.0,1,0.0,0,13,313,326,1
1589947200.0,2,1.0,1,14,720,734,1
1589947200.0,3,2.3333333333333335,2,11,718,729,1
1589947200.0,1,0.0,0,10,229,239,1
1589947200.0,0,0.0,0,12,591,603,1
1589947200.0,1,0.0,0,16,808,824,1
1589947200.0,1,0.0,0,11,457,468,1
1589947200.0,0,0.0,0,10,852,862,1
1589947200.0,1,0.0,0,17,852,869,1
1589947200.0,1,0.0,0,14,1591,1605,1
1589947200.0,5,4.0,4,16,1615,1631,1
1589947200.0,1,0.0,0,17,876,893,1
1589947200.0,1,0.0,0,12,1461,1473,1
1589947200.0,0,0.0,0,15,343,358,1
1589947200.0,0,0.0,0,10,517,527,1
1589947200.0,2,2.0,2,12,675,687,1
1589947200.0,1,0.0,0,14,322,336,1
1589947200.0,1,0.0,0,16,1038,1054,1
1589947200.0,2,2.0,2,12,2457,2469,1
1590033600.0,0,0.0,0,14,1435,1449,1
1590033600.0,0,0.0,0,9,1466,1475,1
1590033600.0,1,0.0,0,13,498,511,1
1590033600.0,1,0.0,0,5,1409,1414,1
1590033600.0,1,0.0,0,10,2165,2175,1
1590033600.0,0,0.0,0,10,878,888,1
1590033600.0,1,0.0,0,15,421,436,1
1590033600.0,2,1.0,1,9,435,444,1
1590033600.0,2,1.0,1,14,266,280,1
1590033600.0,1,0.0,0,22,1221,1243,1
1590033600.0,1,0.0,0,8,1268,1276,1
1590033600.0,1,0.0,0,5,1525,1530,1
1590033600.0,1,0.0,0,6,933,939,1
1590033600.0,1,0.0,0,13,314,327,1
1590033600.0,1,0.0,0,13,2274,2287,1
1590033600.0,1,0.0,0,14,602,616,1
1590033600.0,1,0.0,0,11,360,371,1
1590033600.0,2,1.0,1,14,93,107,1
1590033600.0,8,7.0,7,11,336,347,1
1590033600.0,0,0.0,0,11,894,905,1
1590033600.0,1,0.0,0,10,452,462,1
1590033600.0,1,0.0,0,5,745,750,1
1590033600.0,1,0.0,0,15,1198,1213,1
1590033600.0,1,0.0,0,20,1228,1248,1
1590033600.0,1,0.0,0,23,592,615,1
1590033600.0,1,0.0,0,14,538,552,1
1590033600.0,0,0.0,0,15,1312,1327,1
1590033600.0,1,0.0,0,13,824,837,1
1590033600.0,1,0.0,0,12,667,679,1
1590033600.0,1,0.0,0,15,2350,2365,1
1590033600.0,1,0.0,0,25,728,753,1
1590033600.0,1,0.0,0,8,611,619,1
1590033600.0,0,0.0,0,17,1229,1246,1
1590033600.0,1,0.0,0,17,615,632,1
1590033600.0,0,0.0,0,12,352,364,1
1590033600.0,1,0.0,0,10,599,609,1
1590033600.0,0,0.0,0,14,1060,1074,1
1590033600.0,1,0.0,0,7,1058,1065,1
1590033600.0,1,0.0,0,12,668,680,1
1590033600.0,1,0.0,0,14,661,675,1
1590033600.0,0,0.0,0,14,640,654,1
1590033600.0,1,1.0,1,16,851,867,1
1590033600.0,1,0.0,0,8,1943,1951,1
1590033600.0,1,0.0,0,13,193,206,1
1590033600.0,0,0.0,0,18,1159,1177,1
1590033600.0,0,0.0,0,14,397,411,1
1590033600.0,1,0.0,0,11,7101,7112,1
1590033600.0,0,0.0,0,10,371,381,1
1590033600.0,2,1.0,1,11,799,810,1
1590033600.0,1,0.0,0,20,461,481,1
1590033600.0,0,0.0,0,15,453,468,1
1590033600.0,1,0.0,0,15,858,873,1
1590033600.0,1,1.0,1,11,343,354,1
1590033600.0,2,1.0,1,17,615,632,1
1590033600.0,1,0.0,0,15,1399,1414,1
1590033600.0,1,0.0,0,7,1161,1168,1
1590033600.0,2,1.0,1,10,993,1003,1
1590033600.0,1,0.0,0,13,340,353,1
1590033600.0,0,0.0,0,10,246,256,1
1590033600.0,1,0.0,0,7,554,561,1
1590033600.0,1,0.0,0,6,602,608,1
1590033600.0,1,1.0,1,8,602,610,1
1590033600.0,1,0.0,0,8,838,846,1
1590033600.0,1,0.0,0,10,858,868,1
1590033600.0,1,0.0,0,8,664,672,1
1590033600.0,1,0.0,0,10,924,934,1
1590033600.0,1,0.0,0,14,637,651,1
1590033600.0,1,0.0,0,11,602,613,1
1590033600.0,1,2.0,2,16,812,828,1
1590033600.0,1,0.0,0,7,618,625,1
1590033600.0,1,0.0,0,16,483,499,1
1590033600.0,1,0.0,0,12,926,938,1
1590033600.0,1,0.0,0,18,922,940,1
1590033600.0,1,0.0,0,10,535,545,1
1590033600.0,1,0.0,0,8,1736,1744,1
1590033600.0,0,0.0,0,13,343,356,1
1590033600.0,0,0.0,0,13,96,109,1
1590033600.0,1,0.0,0,13,795,808,1
1590033600.0,1,0.0,0,17,621,638,1
1590033600.0,0,0.0,0,8,41,49,1
1590033600.0,0,0.0,0,20,168,188,1
1590033600.0,0,0.0,0,11,519,530,1
1590033600.0,0,0.0,0,19,159,178,1
1590033600.0,1,0.0,0,15,633,648,1
1590033600.0,0,0.0,0,12,96,108,1
1590033600.0,0,0.0,0,10,49,59,1
1590033600.0,1,0.0,0,20,873,893,1
1590033600.0,0,0.0,0,16,736,752,1
1590033600.0,0,0.0,0,9,144,153,1
1590033600.0,0,0.0,0,8,487,495,1
1590033600.0,0,0.0,0,13,363,376,1
1590033600.0,0,0.0,0,15,919,934,1
1590120000.0,0,0.0,0,17,219,236,1
1590120000.0,0,0.0,0,16,532,548,1
1590120000.0,0,0.0,0,8,191,199,1
1590120000.0,0,0.0,0,11,96,107,1
1590120000.0,0,0.0,0,9,216,225,1
1590120000.0,1,0.0,0,15,979,994,1
1590120000.0,0,0.0,0,1,126,127,1
1590120000.0,0,0.0,0,12,4185,4197,1
1590120000.0,1,0.0,0,11,1528,1539,1
1590120000.0,1,0.0,0,14,734,748,1
1590120000.0,1,0.0,0,13,756,769,1
1590120000.0,0,0.0,0,16,615,631,1
1590120000.0,1,0.0,0,15,2908,2923,1
1590120000.0,0,0.0,0,13,508,521,1
1590120000.0,0,0.0,0,12,356,368,1
1590120000.0,1,0.0,0,9,288,297,1
1590120000.0,0,0.0,0,14,466,480,1
1590120000.0,0,0.0,0,14,1229,1243,1
1590120000.0,1,0.0,0,10,891,901,1
1590120000.0,0,0.0,0,16,318,334,1
1590120000.0,0,0.0,0,14,398,412,1
1590120000.0,1,0.0,0,10,533,543,1
1590120000.0,0,0.0,0,15,235,250,1
1590120000.0,0,0.0,0,11,198,209,1
1590120000.0,1,0.0,0,11,318,329,1
1590120000.0,0,0.0,0,7,383,390,1
1590120000.0,1,0.0,0,21,1158,1179,1
1590120000.0,0,0.0,0,7,1466,1473,1
1590120000.0,1,0.0,0,13,608,621,1
1590120000.0,1,0.0,0,10,535,545,1
1590120000.0,0,0.0,0,10,1656,1666,1
1590120000.0,2,1.0,1,10,361,371,1
1590120000.0,0,0.0,0,9,300,309,1
1590120000.0,0,0.0,0,19,411,430,1
1590120000.0,0,0.0,0,18,2853,2871,1
1590120000.0,2,1.0,1,17,1087,1104,1
1590120000.0,1,0.0,0,10,956,966,1
1590120000.0,1,0.0,0,14,596,610,1
1590120000.0,2,1.0,1,19,98,117,1
1590120000.0,0,0.0,0,12,621,633,1
1590120000.0,0,0.0,0,14,575,589,1
1590120000.0,0,0.0,0,14,831,845,1
1590120000.0,0,0.0,0,8,526,534,1
1590120000.0,1,0.0,0,12,1907,1919,1
1590120000.0,0,0.0,0,14,475,489,1
1590120000.0,0,0.0,0,10,463,473,1
1590120000.0,1,0.0,0,5,300,305,1
1590120000.0,0,0.0,0,12,96,108,1
1590120000.0,0,0.0,0,21,280,301,1
1590120000.0,0,0.0,0,13,96,109,1
1590120000.0,0,0.0,0,15,276,291,1
1590120000.0,0,0.0,0,21,328,349,1
1590120000.0,0,0.0,0,10,359,369,1
1590120000.0,1,0.0,0,16,1035,1051,1
1590120000.0,0,0.0,0,14,350,364,1
1590120000.0,0,0.0,0,14,402,416,1
1590120000.0,0,0.0,0,13,425,438,1
1590120000.0,0,0.0,0,8,2458,2466,1
1590120000.0,0,0.0,0,14,712,726,1
1590120000.0,0,0.0,0,9,482,491,1
1590120000.0,0,0.0,0,15,332,347,1
1590120000.0,1,0.0,0,5,983,988,1
1590120000.0,2,1.0,1,9,305,314,1
1590120000.0,0,0.0,0,14,237,251,1
1590120000.0,1,0.0,0,8,1461,1469,1
1590120000.0,0,0.0,0,11,96,107,1
1590120000.0,1,0.0,0,14,279,293,1
1590120000.0,1,0.0,0,16,922,938,1
1590120000.0,0,0.0,0,15,165,180,1
1590120000.0,0,0.0,0,11,286,297,1
1590120000.0,0,0.0,0,9,1229,1238,1
1590120000.0,0,0.0,0,13,1229,1242,1
1590120000.0,0,0.0,0,9,1229,1238,1
1590120000.0,3,2.0,2,15,136,151,1
1590120000.0,1,0.0,0,12,383,395,1
1590120000.0,1,0.0,0,14,1059,1073,1
1590120000.0,1,0.0,0,4,808,812,1
1590120000.0,0,0.0,0,4,1229,1233,1
1590120000.0,1,0.0,0,23,506,529,1
1590120000.0,1,0.0,0,6,2516,2522,1
1590120000.0,1,0.0,0,8,1200,1208,1
1590120000.0,0,0.0,0,6,1229,1235,1
1590120000.0,0,0.0,0,8,1229,1237,1
1590120000.0,1,0.0,0,13,313,326,1
1590120000.0,1,0.0,0,8,204,212,1
1590120000.0,0,0.0,0,9,341,350,1
1590120000.0,1,0.0,0,11,602,613,1
1590120000.0,1,0.0,0,5,602,607,1
1590120000.0,1,0.0,0,9,602,611,1
1590120000.0,1,0.0,0,14,632,646,1
1590120000.0,1,0.0,0,14,834,848,1
1590120000.0,1,0.0,0,8,602,610,1
1590120000.0,1,0.0,0,9,602,611,1
1590120000.0,2,1.0,1,9,688,697,1
1590120000.0,3,2.0,2,12,620,632,1
1590120000.0,1,1.0,1,14,917,931,1
1590120000.0,3,2.0,2,5,2674,2679,1
1590120000.0,1,0.0,0,8,889,897,1
1590120000.0,0,0.0,0,20,182,202,1
1590120000.0,1,0.0,0,13,602,615,1
1590120000.0,1,0.0,0,11,640,651,1
1590120000.0,0,0.0,0,14,1229,1243,1
1590120000.0,0,0.0,0,12,387,399,1
1590120000.0,0,0.0,0,16,808,824,1
1590120000.0,1,0.0,0,11,700,711,1
1590120000.0,1,0.0,0,12,1837,1849,1
1590120000.0,1,0.0,0,11,972,983,1
1590120000.0,0,0.0,0,24,800,824,1
1590120000.0,0,0.0,0,7,848,855,1
1590120000.0,0,0.0,0,11,25,36,1
1590120000.0,1,0.0,0,23,1478,1501,1
1590120000.0,1,0.0,0,18,344,362,1
1590120000.0,0,0.0,0,14,412,426,1
1590120000.0,1,0.0,0,13,656,669,1
1590120000.0,1,0.0,0,12,1066,1078,1
1590120000.0,1,0.0,0,14,702,716,1
1590120000.0,1,0.0,0,11,838,849,1
1590120000.0,1,0.0,0,7,670,677,1
1590120000.0,0,0.0,0,9,438,447,1
1590120000.0,1,0.0,0,20,274,294,1
1590120000.0,1,0.0,0,22,631,653,1
1590120000.0,1,0.0,0,11,671,682,1
1590120000.0,1,1.0,1,7,919,926,1
1590120000.0,2,1.0,1,12,771,783,1
1590120000.0,1,1.0,1,13,627,640,1
1590120000.0,0,0.0,0,12,661,673,1
1590120000.0,0,0.0,0,18,2791,2809,1
1590120000.0,1,1.0,1,17,589,606,1
1590120000.0,0,0.0,0,10,525,535,1
1590120000.0,0,0.0,0,12,845,857,1
1590120000.0,0,0.0,0,9,556,565,1
1590120000.0,0,0.0,0,20,1138,1158,1
1590120000.0,1,0.0,0,19,1005,1024,1
1590120000.0,1,0.0,0,9,1116,1125,1
1590206400.0,1,0.0,0,25,517,542,1
1590206400.0,1,0.0,0,9,234,243,1
1590206400.0,1,0.0,0,15,777,792,1
1590206400.0,1,0.0,0,11,960,971,1
1590206400.0,0,0.0,0,9,514,523,1
1590206400.0,1,0.0,0,8,692,700,1
1590206400.0,0,0.0,0,18,200,218,1
1590206400.0,0,0.0,0,11,284,295,1
1590206400.0,0,0.0,0,7,36,43,1
1590206400.0,0,0.0,0,19,546,565,1
1590206400.0,1,0.0,0,10,654,664,1
1590206400.0,1,0.0,0,22,347,369,1
1590206400.0,0,0.0,0,4,65,69,1
1590206400.0,1,0.0,0,31,552,583,1
1590206400.0,0,0.0,0,8,204,212,1
1590206400.0,0,0.0,0,10,116,126,1
1590206400.0,1,0.0,0,19,432,451,1
1590206400.0,0,0.0,0,10,38,48,1
1590206400.0,0,0.0,0,17,463,480,1
1590206400.0,1,0.0,0,11,763,774,1
1590206400.0,2,0.0,0,14,567,581,1
1590206400.0,0,0.0,0,16,296,312,1
1590206400.0,0,0.0,0,13,510,523,1
1590206400.0,0,0.0,0,13,620,633,1
1590206400.0,0,0.0,0,17,499,516,1
1590206400.0,0,0.0,0,7,2376,2383,1
1590206400.0,1,0.0,0,11,186,197,1
1590206400.0,1,0.0,0,20,1300,1320,1
1590206400.0,0,0.0,0,8,121,129,1
1590206400.0,1,0.0,0,27,629,656,1
1590206400.0,1,0.0,0,12,996,1008,1
1590206400.0,1,0.0,0,18,474,492,1
1590206400.0,0,0.0,0,20,504,524,1
1590206400.0,0,0.0,0,18,388,406,1
1590206400.0,0,0.0,0,6,745,751,1
1590206400.0,0,0.0,0,10,1229,1239,1
1590206400.0,0,0.0,0,14,1229,1243,1
1590206400.0,0,0.0,0,7,1229,1236,1
1590206400.0,0,0.0,0,11,1229,1240,1
1590206400.0,0,0.0,0,7,1229,1236,1
1590206400.0,0,0.0,0,19,1229,1248,1
1590206400.0,1,0.0,0,9,520,529,1
1590206400.0,1,0.0,0,7,1149,1156,1
1590206400.0,1,0.0,0,6,769,775,1
1590206400.0,0,0.0,0,10,1005,1015,1
1590206400.0,1,0.0,0,5,891,896,1
1590206400.0,1,0.0,0,10,769,779,1
1590206400.0,1,0.0,0,9,51,60,1
1590206400.0,1,0.0,0,14,598,612,1
1590206400.0,1,0.0,0,8,506,514,1
1590206400.0,1,0.0,0,16,1235,1251,1
1590206400.0,0,0.0,0,12,267,279,1
1590206400.0,0,0.0,0,10,49,59,1
1590206400.0,0,0.0,0,19,24827,24846,1
1590206400.0,0,0.0,0,11,341,352,1
1590206400.0,0,0.0,0,14,445,459,1
1590206400.0,0,0.0,0,11,1863,1874,1
1590206400.0,0,0.0,0,12,572,584,1
1590206400.0,1,0.0,0,20,1036,1056,1
1590206400.0,1,0.0,0,14,894,908,1
1590206400.0,0,0.0,0,11,323,334,1
1590206400.0,0,0.0,0,15,580,595,1
1590206400.0,0,0.0,0,11,236,247,1
1590206400.0,1,0.0,0,13,344,357,1
1590206400.0,0,0.0,0,11,307,318,1
1590206400.0,0,0.0,0,12,371,383,1
1590206400.0,1,0.0,0,8,228,236,1
1590206400.0,1,0.0,0,10,917,927,1
1590206400.0,0,0.0,0,10,953,963,1
1590206400.0,1,0.0,0,14,609,623,1
1590206400.0,1,0.0,0,11,1859,1870,1
1590206400.0,0,0.0,0,16,598,614,1
1590206400.0,1,0.0,0,8,14238,14246,1
1590206400.0,2,1.5,1,18,825,843,1
1590206400.0,0,0.0,0,19,358,377,1
1590206400.0,0,0.0,0,15,1493,1508,1
1590206400.0,0,0.0,0,15,751,766,1
1590206400.0,1,0.0,0,14,314,328,1
1590206400.0,1,0.0,0,13,326,339,1
1590206400.0,0,0.0,0,17,353,370,1
1590206400.0,1,0.0,0,18,629,647,1
1590206400.0,0,0.0,0,19,328,347,1
1590206400.0,1,0.0,0,14,203,217,1
1590206400.0,2,1.5,1,12,445,457,1
1590206400.0,0,0.0,0,17,869,886,1
1590206400.0,0,0.0,0,12,524,536,1
1590206400.0,1,2.0,2,16,605,621,1
1590206400.0,2,1.5,1,11,487,498,1
1590206400.0,0,0.0,0,15,122,137,1
1590206400.0,0,0.0,0,14,96,110,1
1590206400.0,1,0.0,0,13,524,537,1
1590206400.0,1,0.0,0,12,576,588,1
1590206400.0,0,0.0,0,16,364,380,1
1590206400.0,1,0.0,0,18,586,604,1
1590206400.0,1,0.0,0,11,588,599,1
1590206400.0,1,0.0,0,15,854,869,1
1590206400.0,0,0.0,0,8,777,785,1
1590206400.0,0,0.0,0,18,715,733,1
1590206400.0,0,0.0,0,14,96,110,1
1590206400.0,1,0.0,0,12,680,692,1
1590206400.0,0,0.0,0,9,1186,1195,1
1590206400.0,1,0.0,0,12,228,240,1
1590206400.0,0,0.0,0,28,540,568,1
1590206400.0,0,0.0,0,10,168,178,1
1590206400.0,1,1.0,1,15,408,423,1
1590206400.0,0,0.0,0,9,96,105,1
1590206400.0,0,0.0,0,15,476,491,1
1590206400.0,1,0.0,0,12,583,595,1
1590206400.0,1,0.0,0,8,1210,1218,1
1590206400.0,1,0.0,0,12,684,696,1
1590206400.0,0,0.0,0,13,713,726,1
1590206400.0,0,0.0,0,11,275,286,1
1590206400.0,0,0.0,0,16,606,622,1
1590206400.0,0,0.0,0,14,524,538,1
1590206400.0,1,0.0,0,14,820,834,1
1590206400.0,1,0.0,0,7,611,618,1
1590206400.0,0,0.0,0,15,941,956,1
1590206400.0,0,0.0,0,14,365,379,1
1590206400.0,0,0.0,0,12,461,473,1
1590206400.0,1,0.0,0,13,568,581,1
1590206400.0,0,0.0,0,13,690,703,1
1590206400.0,0,0.0,0,14,500,514,1
1590206400.0,1,0.0,0,8,442,450,1
1590206400.0,0,0.0,0,10,236,246,1
1590206400.0,1,0.0,0,15,699,714,1
1590206400.0,0,0.0,0,9,377,386,1
1590206400.0,1,1.0,1,5,1251,1256,1
1590206400.0,0,0.0,0,5,94,99,1
1590206400.0,0,0.0,0,20,375,395,1
1590206400.0,0,0.0,0,12,357,369,1
1590292800.0,0,0.0,0,8,200,208,1
1590292800.0,0,0.0,0,10,596,606,1
1590292800.0,0,0.0,0,10,246,256,1
1590292800.0,0,0.0,0,13,390,403,1
1590292800.0,0,0.0,0,10,302,312,1
1590292800.0,0,0.0,0,15,96,111,1
1590292800.0,0,0.0,0,10,698,708,1
1590292800.0,0,0.0,0,7,234,241,1
1590292800.0,0,0.0,0,14,372,386,1
1590292800.0,0,0.0,0,6,42,48,1
1590292800.0,0,0.0,0,7,192,199,1
1590292800.0,0,0.0,0,8,168,176,1
1590292800.0,0,0.0,0,10,212,222,1
1590292800.0,0,0.0,0,5,35,40,1
1590292800.0,1,0.0,0,13,553,566,1
1590292800.0,0,0.0,0,12,25,37,1
1590292800.0,0,0.0,0,11,384,395,1
1590292800.0,1,0.0,0,12,673,685,1
1590292800.0,0,0.0,0,10,173,183,1
1590292800.0,0,0.0,0,12,208,220,1
1590292800.0,0,0.0,0,9,414,423,1
1590292800.0,0,0.0,0,8,316,324,1
1590292800.0,1,0.0,0,14,419,433,1
1590292800.0,1,0.0,0,22,903,925,1
1590292800.0,1,0.0,0,21,689,710,1
1590292800.0,0,0.0,0,10,670,680,1
1590292800.0,1,0.0,0,15,536,551,1
1590292800.0,0,0.0,0,13,96,109,1
1590292800.0,0,0.0,0,14,596,610,1
1590292800.0,0,0.0,0,16,910,926,1
1590292800.0,0,0.0,0,16,96,112,1
1590292800.0,1,0.0,0,19,474,493,1
1590292800.0,1,0.0,0,9,265,274,1
1590292800.0,1,0.0,0,11,604,615,1
1590292800.0,0,0.0,0,11,577,588,1
1590292800.0,0,0.0,0,12,503,515,1
1590292800.0,0,0.0,0,12,475,487,1
1590292800.0,0,0.0,0,14,515,529,1
1590292800.0,0,0.0,0,10,367,377,1
1590292800.0,1,0.0,0,16,1177,1193,1
1590292800.0,0,0.0,0,13,522,535,1
1590379200.0,1,0.0,0,8,1296,1304,1
-1.0,2,1.0,1,11,936,947,1
-1.0,1,0.0,0,10,62,72,1
-1.0,2,1.0,1,8,636,644,1
-1.0,1,0.0,0,11,873,884,1
-1.0,1,0.0,0,13,1624,1637,1
-1.0,1,0.0,0,6,149,155,1
-1.0,2,1.0,1,10,1035,1045,1
-1.0,0,0.0,0,7,553,560,1
-1.0,0,0.0,0,8,202,210,1
-1.0,1,0.0,0,9,729,738,1
-1.0,4,3.0,3,13,1300,1313,1
-1.0,1,0.0,0,24,581,605,1
-1.0,1,0.0,0,15,1551,1566,1
-1.0,1,0.0,0,12,692,704,1
-1.0,0,0.0,0,1,1613,1614,0
